ward,name,2010,2020,decade_change,interpolated_2016
0001,pop,3808,3634,-174,3704
0001,pop_aian,8,11,3,10
0001,pop_asian,155,154,-1,154
0001,pop_black,1872,2307,435,2133
0001,pop_hisp,691,537,-154,599
0001,pop_nhpi,0,0,0,0
0001,pop_other,16,13,-3,14
0001,pop_two,107,129,22,120
0001,pop_white,959,483,-476,673
0001,vap,2604,2499,-105,2541
0001,vap_aian,6,7,1,7
0001,vap_asian,120,102,-18,109
0001,vap_black,1138,1553,415,1387
0001,vap_hisp,426,342,-84,376
0001,vap_nhpi,0,0,0,0
0001,vap_other,4,12,8,9
0001,vap_two,50,60,10,56
0001,vap_white,860,423,-437,598
0002,pop,1642,1638,-4,1640
0002,pop_aian,0,0,0,0
0002,pop_asian,7,8,1,8
0002,pop_black,1287,1254,-33,1267
0002,pop_hisp,149,251,102,210
0002,pop_nhpi,0,0,0,0
0002,pop_other,2,22,20,14
0002,pop_two,53,31,-22,40
0002,pop_white,144,72,-72,101
0002,vap,862,899,37,884
0002,vap_aian,0,0,0,0
0002,vap_asian,7,4,-3,5
0002,vap_black,614,659,45,641
0002,vap_hisp,100,134,34,120
0002,vap_nhpi,0,0,0,0
0002,vap_other,1,11,10,7
0002,vap_two,24,20,-4,22
0002,vap_white,116,71,-45,89
0003,pop,2388,2151,-237,2246
0003,pop_aian,8,6,-2,7
0003,pop_asian,89,161,72,132
0003,pop_black,1392,1285,-107,1328
0003,pop_hisp,95,143,48,124
0003,pop_nhpi,0,0,0,0
0003,pop_other,0,13,13,8
0003,pop_two,47,85,38,70
0003,pop_white,757,458,-299,578
0003,vap,1717,1539,-178,1610
0003,vap_aian,6,2,-4,4
0003,vap_asian,51,101,50,81
0003,vap_black,867,850,-17,857
0003,vap_hisp,54,92,38,77
0003,vap_nhpi,0,0,0,0
0003,vap_other,0,3,3,2
0003,vap_two,19,51,32,38
0003,vap_white,720,440,-280,552
0004,pop,3178,3411,233,3318
0004,pop_aian,5,6,1,6
0004,pop_asian,94,106,12,101
0004,pop_black,1841,2317,476,2127
0004,pop_hisp,84,127,43,110
0004,pop_nhpi,3,1,-2,2
0004,pop_other,3,16,13,11
0004,pop_two,99,103,4,101
0004,pop_white,1049,735,-314,861
0004,vap,2497,2692,195,2614
0004,vap_aian,3,6,3,5
0004,vap_asian,81,82,1,82
0004,vap_black,1297,1764,467,1577
0004,vap_hisp,60,92,32,79
0004,vap_nhpi,3,1,-2,2
0004,vap_other,3,12,9,8
0004,vap_two,54,63,9,59
0004,vap_white,996,672,-324,802
0005,pop,1774,1734,-40,1750
0005,pop_aian,12,2,-10,6
0005,pop_asian,35,73,38,58
0005,pop_black,1173,1239,66,1213
0005,pop_hisp,66,80,14,74
0005,pop_nhpi,0,1,1,1
0005,pop_other,5,7,2,6
0005,pop_two,38,66,28,55
0005,pop_white,445,266,-179,338
0005,vap,1366,1344,-22,1353
0005,vap_aian,6,2,-4,4
0005,vap_asian,21,45,24,35
0005,vap_black,866,931,65,905
0005,vap_hisp,37,61,24,51
0005,vap_nhpi,0,1,1,1
0005,vap_other,4,7,3,6
0005,vap_two,12,43,31,31
0005,vap_white,420,254,-166,320
0006,pop,3703,3749,46,3731
0006,pop_aian,19,5,-14,11
0006,pop_asian,230,295,65,269
0006,pop_black,1962,2098,136,2044
0006,pop_hisp,97,212,115,166
0006,pop_nhpi,8,0,-8,3
0006,pop_other,5,28,23,19
0006,pop_two,92,145,53,124
0006,pop_white,1290,966,-324,1096
0006,vap,2593,2755,162,2690
0006,vap_aian,15,5,-10,9
0006,vap_asian,171,207,36,193
0006,vap_black,1181,1438,257,1335
0006,vap_hisp,62,147,85,113
0006,vap_nhpi,5,0,-5,2
0006,vap_other,3,13,10,9
0006,vap_two,36,75,39,59
0006,vap_white,1120,870,-250,970
0007,pop,1574,1393,-181,1465
0007,pop_aian,18,2,-16,8
0007,pop_asian,31,108,77,77
0007,pop_black,724,699,-25,709
0007,pop_hisp,116,120,4,118
0007,pop_nhpi,0,1,1,1
0007,pop_other,3,0,-3,1
0007,pop_two,68,60,-8,63
0007,pop_white,614,403,-211,487
0007,vap,1042,981,-61,1005
0007,vap_aian,13,2,-11,6
0007,vap_asian,20,74,54,52
0007,vap_black,403,444,41,428
0007,vap_hisp,72,68,-4,70
0007,vap_nhpi,0,1,1,1
0007,vap_other,1,0,-1,0
0007,vap_two,21,29,8,26
0007,vap_white,512,363,-149,423
0008,pop,2565,2618,53,2597
0008,pop_aian,7,2,-5,4
0008,pop_asian,70,201,131,149
0008,pop_black,1420,1483,63,1458
0008,pop_hisp,139,144,5,142
0008,pop_nhpi,1,2,1,2
0008,pop_other,6,10,4,8
0008,pop_two,80,122,42,105
0008,pop_white,842,654,-188,729
0008,vap,1865,1957,92,1920
0008,vap_aian,6,2,-4,4
0008,vap_asian,45,129,84,95
0008,vap_black,980,1072,92,1035
0008,vap_hisp,84,91,7,88
0008,vap_nhpi,1,2,1,2
0008,vap_other,0,5,5,3
0008,vap_two,39,84,45,66
0008,vap_white,710,572,-138,627
0009,pop,1545,1590,45,1572
0009,pop_aian,9,1,-8,4
0009,pop_asian,96,233,137,178
0009,pop_black,975,989,14,983
0009,pop_hisp,69,71,2,70
0009,pop_nhpi,2,0,-2,1
0009,pop_other,6,7,1,7
0009,pop_two,36,64,28,53
0009,pop_white,352,225,-127,276
0009,vap,1052,1097,45,1079
0009,vap_aian,9,1,-8,4
0009,vap_asian,57,151,94,113
0009,vap_black,638,667,29,655
0009,vap_hisp,34,46,12,41
0009,vap_nhpi,2,0,-2,1
0009,vap_other,2,4,2,3
0009,vap_two,14,33,19,25
0009,vap_white,296,195,-101,235
0010,pop,2433,2420,-13,2425
0010,pop_aian,7,1,-6,3
0010,pop_asian,230,494,264,388
0010,pop_black,994,1036,42,1019
0010,pop_hisp,93,114,21,106
0010,pop_nhpi,0,0,0,0
0010,pop_other,9,17,8,14
0010,pop_two,52,79,27,68
0010,pop_white,1048,679,-369,827
0010,vap,1798,1779,-19,1787
0010,vap_aian,5,0,-5,2
0010,vap_asian,138,284,146,226
0010,vap_black,679,754,75,724
0010,vap_hisp,61,78,17,71
0010,vap_nhpi,0,0,0,0
0010,vap_other,3,4,1,4
0010,vap_two,23,44,21,36
0010,vap_white,889,615,-274,725
0011,pop,2270,2199,-71,2227
0011,pop_aian,6,1,-5,3
0011,pop_asian,255,461,206,379
0011,pop_black,1156,1106,-50,1126
0011,pop_hisp,89,140,51,120
0011,pop_nhpi,0,0,0,0
0011,pop_other,0,7,7,4
0011,pop_two,65,89,24,79
0011,pop_white,699,395,-304,517
0011,vap,1637,1644,7,1641
0011,vap_aian,5,1,-4,3
0011,vap_asian,151,274,123,225
0011,vap_black,795,835,40,819
0011,vap_hisp,58,107,49,87
0011,vap_nhpi,0,0,0,0
0011,vap_other,0,4,4,2
0011,vap_two,24,63,39,47
0011,vap_white,604,360,-244,458
0012,pop,2264,2123,-141,2179
0012,pop_aian,8,5,-3,6
0012,pop_asian,365,577,212,492
0012,pop_black,1338,1164,-174,1234
0012,pop_hisp,62,79,17,72
0012,pop_nhpi,0,0,0,0
0012,pop_other,0,3,3,2
0012,pop_two,77,74,-3,75
0012,pop_white,415,221,-194,299
0012,vap,1440,1372,-68,1399
0012,vap_aian,4,2,-2,3
0012,vap_asian,210,349,139,293
0012,vap_black,798,761,-37,776
0012,vap_hisp,29,41,12,36
0012,vap_nhpi,0,0,0,0
0012,vap_other,0,3,3,2
0012,vap_two,28,29,1,29
0012,vap_white,372,187,-185,261
0013,pop,1027,1083,56,1061
0013,pop_aian,2,0,-2,1
0013,pop_asian,101,217,116,171
0013,pop_black,533,561,28,550
0013,pop_hisp,21,27,6,25
0013,pop_nhpi,1,0,-1,0
0013,pop_other,1,4,3,3
0013,pop_two,42,43,1,43
0013,pop_white,326,231,-95,269
0013,vap,773,778,5,776
0013,vap_aian,2,0,-2,1
0013,vap_asian,57,129,72,100
0013,vap_black,395,400,5,398
0013,vap_hisp,15,19,4,17
0013,vap_nhpi,1,0,-1,0
0013,vap_other,1,3,2,2
0013,vap_two,16,20,4,18
0013,vap_white,286,207,-79,239
0014,pop,2289,2214,-75,2244
0014,pop_aian,3,1,-2,2
0014,pop_asian,18,24,6,22
0014,pop_black,1736,1853,117,1806
0014,pop_hisp,73,86,13,81
0014,pop_nhpi,0,0,0,0
0014,pop_other,0,0,0,0
0014,pop_two,79,67,-12,72
0014,pop_white,380,183,-197,262
0014,vap,1651,1591,-60,1615
0014,vap_aian,2,1,-1,1
0014,vap_asian,15,17,2,16
0014,vap_black,1200,1305,105,1263
0014,vap_hisp,44,55,11,51
0014,vap_nhpi,0,0,0,0
0014,vap_other,0,0,0,0
0014,vap_two,32,42,10,38
0014,vap_white,358,171,-187,246
0015,pop,1285,1340,55,1318
0015,pop_aian,16,5,-11,9
0015,pop_asian,71,198,127,147
0015,pop_black,380,399,19,391
0015,pop_hisp,34,144,110,100
0015,pop_nhpi,0,3,3,2
0015,pop_other,1,7,6,5
0015,pop_two,26,62,36,48
0015,pop_white,757,522,-235,616
0015,vap,988,1015,27,1004
0015,vap_aian,11,5,-6,7
0015,vap_asian,37,110,73,81
0015,vap_black,284,329,45,311
0015,vap_hisp,26,87,61,63
0015,vap_nhpi,0,3,3,2
0015,vap_other,1,7,6,5
0015,vap_two,10,38,28,27
0015,vap_white,619,436,-183,509
0016,pop,3305,3077,-228,3168
0016,pop_aian,18,9,-9,13
0016,pop_asian,168,257,89,221
0016,pop_black,2224,2126,-98,2165
0016,pop_hisp,119,140,21,132
0016,pop_nhpi,0,0,0,0
0016,pop_other,8,7,-1,7
0016,pop_two,133,119,-14,125
0016,pop_white,635,419,-216,505
0016,vap,2313,2234,-79,2266
0016,vap_aian,13,3,-10,7
0016,vap_asian,90,164,74,134
0016,vap_black,1505,1506,1,1506
0016,vap_hisp,69,103,34,89
0016,vap_nhpi,0,0,0,0
0016,vap_other,5,7,2,6
0016,vap_two,49,63,14,57
0016,vap_white,582,388,-194,466
0017,pop,1268,1249,-19,1257
0017,pop_aian,2,2,0,2
0017,pop_asian,64,73,9,69
0017,pop_black,663,655,-8,658
0017,pop_hisp,68,106,38,91
0017,pop_nhpi,0,1,1,1
0017,pop_other,9,9,0,9
0017,pop_two,39,116,77,85
0017,pop_white,423,287,-136,341
0017,vap,909,928,19,920
0017,vap_aian,2,0,-2,1
0017,vap_asian,44,41,-3,42
0017,vap_black,435,480,45,462
0017,vap_hisp,37,60,23,51
0017,vap_nhpi,0,1,1,1
0017,vap_other,2,7,5,5
0017,vap_two,24,80,56,58
0017,vap_white,365,259,-106,301
0018,pop,2070,1889,-181,1961
0018,pop_aian,7,1,-6,3
0018,pop_asian,40,129,89,93
0018,pop_black,1432,1188,-244,1286
0018,pop_hisp,73,116,43,99
0018,pop_nhpi,0,0,0,0
0018,pop_other,0,6,6,4
0018,pop_two,43,87,44,69
0018,pop_white,475,362,-113,407
0018,vap,1388,1357,-31,1369
0018,vap_aian,4,1,-3,2
0018,vap_asian,29,77,48,58
0018,vap_black,886,824,-62,849
0018,vap_hisp,41,80,39,64
0018,vap_nhpi,0,0,0,0
0018,vap_other,0,4,4,2
0018,vap_two,23,48,25,38
0018,vap_white,405,323,-82,356
0019,pop,1954,2016,62,1991
0019,pop_aian,8,9,1,9
0019,pop_asian,20,133,113,88
0019,pop_black,1517,1474,-43,1491
0019,pop_hisp,57,99,42,82
0019,pop_nhpi,2,2,0,2
0019,pop_other,0,7,7,4
0019,pop_two,53,80,27,69
0019,pop_white,297,212,-85,246
0019,vap,1119,1202,83,1169
0019,vap_aian,5,4,-1,4
0019,vap_asian,14,85,71,57
0019,vap_black,794,826,32,813
0019,vap_hisp,22,56,34,42
0019,vap_nhpi,2,2,0,2
0019,vap_other,0,2,2,1
0019,vap_two,24,38,14,32
0019,vap_white,258,189,-69,217
0020,pop,2215,1977,-238,2072
0020,pop_aian,13,3,-10,7
0020,pop_asian,26,30,4,28
0020,pop_black,1650,1522,-128,1573
0020,pop_hisp,93,110,17,103
0020,pop_nhpi,0,0,0,0
0020,pop_other,2,11,9,7
0020,pop_two,51,75,24,65
0020,pop_white,380,226,-154,288
0020,vap,1501,1422,-79,1454
0020,vap_aian,7,3,-4,5
0020,vap_asian,15,24,9,20
0020,vap_black,1079,1053,-26,1063
0020,vap_hisp,52,86,34,72
0020,vap_nhpi,0,0,0,0
0020,vap_other,2,11,9,7
0020,vap_two,17,47,30,35
0020,vap_white,329,198,-131,250
0021,pop,2060,1954,-106,1996
0021,pop_aian,10,5,-5,7
0021,pop_asian,5,32,27,21
0021,pop_black,1761,1677,-84,1711
0021,pop_hisp,49,54,5,52
0021,pop_nhpi,0,0,0,0
0021,pop_other,2,9,7,6
0021,pop_two,42,65,23,56
0021,pop_white,191,112,-79,144
0021,vap,1327,1296,-31,1308
0021,vap_aian,5,5,0,5
0021,vap_asian,5,26,21,18
0021,vap_black,1091,1091,0,1091
0021,vap_hisp,28,32,4,30
0021,vap_nhpi,0,0,0,0
0021,vap_other,0,5,5,3
0021,vap_two,19,34,15,28
0021,vap_white,179,103,-76,133
0022,pop,2007,1857,-150,1917
0022,pop_aian,12,4,-8,7
0022,pop_asian,36,31,-5,33
0022,pop_black,1508,1453,-55,1475
0022,pop_hisp,69,86,17,79
0022,pop_nhpi,0,0,0,0
0022,pop_other,2,5,3,4
0022,pop_two,75,73,-2,74
0022,pop_white,305,205,-100,245
0022,vap,1317,1287,-30,1299
0022,vap_aian,10,4,-6,6
0022,vap_asian,19,26,7,23
0022,vap_black,932,972,40,956
0022,vap_hisp,42,59,17,52
0022,vap_nhpi,0,0,0,0
0022,vap_other,2,3,1,3
0022,vap_two,30,25,-5,27
0022,vap_white,282,198,-84,232
0023,pop,1196,1157,-39,1173
0023,pop_aian,6,0,-6,2
0023,pop_asian,133,108,-25,118
0023,pop_black,843,866,23,857
0023,pop_hisp,38,63,25,53
0023,pop_nhpi,10,0,-10,4
0023,pop_other,0,2,2,1
0023,pop_two,26,30,4,28
0023,pop_white,140,88,-52,109
0023,vap,743,742,-1,742
0023,vap_aian,6,0,-6,2
0023,vap_asian,69,70,1,70
0023,vap_black,505,531,26,521
0023,vap_hisp,24,37,13,32
0023,vap_nhpi,2,0,-2,1
0023,vap_other,0,2,2,1
0023,vap_two,13,17,4,15
0023,vap_white,125,85,-40,101
0024,pop,1803,1731,-72,1760
0024,pop_aian,1,4,3,3
0024,pop_asian,519,504,-15,510
0024,pop_black,1180,1096,-84,1130
0024,pop_hisp,10,49,39,33
0024,pop_nhpi,0,0,0,0
0024,pop_other,1,1,0,1
0024,pop_two,33,44,11,40
0024,pop_white,59,33,-26,43
0024,vap,1008,1014,6,1012
0024,vap_aian,1,4,3,3
0024,vap_asian,266,306,40,290
0024,vap_black,673,629,-44,647
0024,vap_hisp,5,20,15,14
0024,vap_nhpi,0,0,0,0
0024,vap_other,1,1,0,1
0024,vap_two,10,22,12,17
0024,vap_white,52,32,-20,40
0025,pop,2072,2050,-22,2059
0025,pop_aian,9,11,2,10
0025,pop_asian,190,244,54,222
0025,pop_black,1444,1464,20,1456
0025,pop_hisp,113,93,-20,101
0025,pop_nhpi,0,0,0,0
0025,pop_other,6,20,14,14
0025,pop_two,45,75,30,63
0025,pop_white,265,143,-122,192
0025,vap,1306,1323,17,1316
0025,vap_aian,7,11,4,9
0025,vap_asian,104,147,43,130
0025,vap_black,880,916,36,902
0025,vap_hisp,55,67,12,62
0025,vap_nhpi,0,0,0,0
0025,vap_other,3,8,5,6
0025,vap_two,19,43,24,33
0025,vap_white,238,131,-107,174
0026,pop,1659,1634,-25,1644
0026,pop_aian,1,17,16,11
0026,pop_asian,198,212,14,206
0026,pop_black,1060,1121,61,1097
0026,pop_hisp,57,65,8,62
0026,pop_nhpi,0,0,0,0
0026,pop_other,0,13,13,8
0026,pop_two,50,66,16,60
0026,pop_white,292,140,-152,201
0026,vap,1121,1125,4,1123
0026,vap_aian,1,9,8,6
0026,vap_asian,107,144,37,129
0026,vap_black,696,763,67,736
0026,vap_hisp,29,33,4,31
0026,vap_nhpi,0,0,0,0
0026,vap_other,0,9,9,5
0026,vap_two,22,34,12,29
0026,vap_white,266,133,-133,186
0027,pop,1794,1635,-159,1699
0027,pop_aian,4,6,2,5
0027,pop_asian,494,510,16,504
0027,pop_black,987,857,-130,909
0027,pop_hisp,61,63,2,62
0027,pop_nhpi,0,0,0,0
0027,pop_other,0,5,5,3
0027,pop_two,34,36,2,35
0027,pop_white,214,158,-56,180
0027,vap,1176,1097,-79,1129
0027,vap_aian,2,5,3,4
0027,vap_asian,260,321,61,297
0027,vap_black,666,583,-83,616
0027,vap_hisp,37,36,-1,36
0027,vap_nhpi,0,0,0,0
0027,vap_other,0,4,4,2
0027,vap_two,18,10,-8,13
0027,vap_white,193,138,-55,160
0028,pop,1081,900,-181,972
0028,pop_aian,3,2,-1,2
0028,pop_asian,468,267,-201,347
0028,pop_black,470,530,60,506
0028,pop_hisp,40,18,-22,27
0028,pop_nhpi,0,0,0,0
0028,pop_other,0,3,3,2
0028,pop_two,25,23,-2,24
0028,pop_white,75,57,-18,64
0028,vap,613,558,-55,580
0028,vap_aian,2,2,0,2
0028,vap_asian,243,168,-75,198
0028,vap_black,272,322,50,302
0028,vap_hisp,22,14,-8,17
0028,vap_nhpi,0,0,0,0
0028,vap_other,0,0,0,0
0028,vap_two,11,3,-8,6
0028,vap_white,63,49,-14,55
0029,pop,1163,1046,-117,1093
0029,pop_aian,0,1,1,1
0029,pop_asian,68,57,-11,61
0029,pop_black,828,803,-25,813
0029,pop_hisp,24,39,15,33
0029,pop_nhpi,0,0,0,0
0029,pop_other,0,1,1,1
0029,pop_two,62,57,-5,59
0029,pop_white,181,88,-93,125
0029,vap,756,686,-70,714
0029,vap_aian,0,1,1,1
0029,vap_asian,32,36,4,34
0029,vap_black,530,505,-25,515
0029,vap_hisp,12,24,12,19
0029,vap_nhpi,0,0,0,0
0029,vap_other,0,0,0,0
0029,vap_two,20,36,16,30
0029,vap_white,162,84,-78,115
0030,pop,1730,1875,145,1817
0030,pop_aian,6,6,0,6
0030,pop_asian,191,320,129,268
0030,pop_black,1089,1171,82,1138
0030,pop_hisp,67,60,-7,63
0030,pop_nhpi,0,2,2,1
0030,pop_other,0,3,3,2
0030,pop_two,25,89,64,63
0030,pop_white,352,224,-128,275
0030,vap,1146,1246,100,1206
0030,vap_aian,5,6,1,6
0030,vap_asian,110,192,82,159
0030,vap_black,685,755,70,727
0030,vap_hisp,37,31,-6,33
0030,vap_nhpi,0,2,2,1
0030,vap_other,0,3,3,2
0030,vap_two,12,40,28,29
0030,vap_white,297,217,-80,249
0031,pop,2115,2136,21,2128
0031,pop_aian,7,9,2,8
0031,pop_asian,99,202,103,161
0031,pop_black,1553,1496,-57,1519
0031,pop_hisp,80,127,47,108
0031,pop_nhpi,0,0,0,0
0031,pop_other,1,6,5,4
0031,pop_two,68,97,29,85
0031,pop_white,307,199,-108,242
0031,vap,1244,1321,77,1290
0031,vap_aian,6,9,3,8
0031,vap_asian,54,130,76,100
0031,vap_black,862,892,30,880
0031,vap_hisp,42,75,33,62
0031,vap_nhpi,0,0,0,0
0031,vap_other,1,4,3,3
0031,vap_two,24,41,17,34
0031,vap_white,255,170,-85,204
0032,pop,3905,3757,-148,3816
0032,pop_aian,5,11,6,9
0032,pop_asian,182,379,197,300
0032,pop_black,2601,2375,-226,2465
0032,pop_hisp,154,256,102,215
0032,pop_nhpi,2,1,-1,1
0032,pop_other,2,25,23,16
0032,pop_two,139,153,14,147
0032,pop_white,820,557,-263,662
0032,vap,2555,2485,-70,2513
0032,vap_aian,4,10,6,8
0032,vap_asian,116,245,129,193
0032,vap_black,1563,1512,-51,1532
0032,vap_hisp,87,132,45,114
0032,vap_nhpi,2,1,-1,1
0032,vap_other,1,13,12,8
0032,vap_two,41,74,33,61
0032,vap_white,741,498,-243,595
0033,pop,3844,3535,-309,3659
0033,pop_aian,16,16,0,16
0033,pop_asian,106,190,84,156
0033,pop_black,1085,1222,137,1167
0033,pop_hisp,157,250,93,213
0033,pop_nhpi,4,0,-4,2
0033,pop_other,6,14,8,11
0033,pop_two,130,170,40,154
0033,pop_white,2340,1673,-667,1940
0033,vap,2795,2683,-112,2728
0033,vap_aian,11,12,1,12
0033,vap_asian,70,118,48,99
0033,vap_black,713,888,175,818
0033,vap_hisp,76,133,57,110
0033,vap_nhpi,2,0,-2,1
0033,vap_other,0,8,8,5
0033,vap_two,48,85,37,70
0033,vap_white,1875,1439,-436,1613
0034,pop,2897,3000,103,2959
0034,pop_aian,15,12,-3,13
0034,pop_asian,82,231,149,171
0034,pop_black,1445,1606,161,1542
0034,pop_hisp,155,192,37,177
0034,pop_nhpi,4,1,-3,2
0034,pop_other,10,27,17,20
0034,pop_two,123,137,14,131
0034,pop_white,1063,794,-269,902
0034,vap,2066,2165,99,2125
0034,vap_aian,12,12,0,12
0034,vap_asian,58,161,103,120
0034,vap_black,939,1052,113,1007
0034,vap_hisp,89,122,33,109
0034,vap_nhpi,4,0,-4,2
0034,vap_other,6,22,16,16
0034,vap_two,48,90,42,73
0034,vap_white,910,706,-204,788
0035,pop,2013,2019,6,2017
0035,pop_aian,15,7,-8,10
0035,pop_asian,72,186,114,140
0035,pop_black,719,950,231,858
0035,pop_hisp,137,154,17,147
0035,pop_nhpi,1,0,-1,0
0035,pop_other,1,9,8,6
0035,pop_two,77,87,10,83
0035,pop_white,991,626,-365,772
0035,vap,1432,1467,35,1453
0035,vap_aian,10,5,-5,7
0035,vap_asian,55,126,71,98
0035,vap_black,448,632,184,558
0035,vap_hisp,81,100,19,92
0035,vap_nhpi,1,0,-1,0
0035,vap_other,0,9,9,5
0035,vap_two,26,38,12,33
0035,vap_white,812,557,-255,659
0036,pop,1748,1728,-20,1736
0036,pop_aian,1,9,8,6
0036,pop_asian,147,122,-25,132
0036,pop_black,1158,1274,116,1228
0036,pop_hisp,37,61,24,51
0036,pop_nhpi,0,2,2,1
0036,pop_other,4,6,2,5
0036,pop_two,63,57,-6,59
0036,pop_white,338,197,-141,253
0036,vap,1158,1237,79,1205
0036,vap_aian,1,9,8,6
0036,vap_asian,87,77,-10,81
0036,vap_black,730,888,158,825
0036,vap_hisp,18,33,15,27
0036,vap_nhpi,0,2,2,1
0036,vap_other,3,2,-1,2
0036,vap_two,24,43,19,35
0036,vap_white,294,183,-111,227
0037,pop,2724,2220,-504,2422
0037,pop_aian,21,2,-19,10
0037,pop_asian,79,131,52,110
0037,pop_black,2078,1676,-402,1837
0037,pop_hisp,89,79,-10,83
0037,pop_nhpi,1,0,-1,0
0037,pop_other,0,7,7,4
0037,pop_two,114,69,-45,87
0037,pop_white,342,256,-86,290
0037,vap,1721,1456,-265,1562
0037,vap_aian,16,2,-14,8
0037,vap_asian,40,89,49,69
0037,vap_black,1253,1064,-189,1140
0037,vap_hisp,53,38,-15,44
0037,vap_nhpi,1,0,-1,0
0037,vap_other,0,7,7,4
0037,vap_two,35,38,3,37
0037,vap_white,323,218,-105,260
0038,pop,1517,1486,-31,1498
0038,pop_aian,10,2,-8,5
0038,pop_asian,18,98,80,66
0038,pop_black,1160,1107,-53,1128
0038,pop_hisp,54,90,36,76
0038,pop_nhpi,0,0,0,0
0038,pop_other,5,12,7,9
0038,pop_two,44,69,25,59
0038,pop_white,226,108,-118,155
0038,vap,977,986,9,982
0038,vap_aian,5,2,-3,3
0038,vap_asian,10,45,35,31
0038,vap_black,719,730,11,726
0038,vap_hisp,33,54,21,46
0038,vap_nhpi,0,0,0,0
0038,vap_other,1,8,7,5
0038,vap_two,15,43,28,32
0038,vap_white,194,104,-90,140
0039,pop,1590,1593,3,1592
0039,pop_aian,7,6,-1,6
0039,pop_asian,115,179,64,153
0039,pop_black,847,928,81,896
0039,pop_hisp,46,111,65,85
0039,pop_nhpi,2,3,1,3
0039,pop_other,5,5,0,5
0039,pop_two,42,48,6,46
0039,pop_white,526,313,-213,398
0039,vap,1086,1075,-11,1079
0039,vap_aian,5,6,1,6
0039,vap_asian,66,122,56,100
0039,vap_black,525,589,64,563
0039,vap_hisp,25,48,23,39
0039,vap_nhpi,2,3,1,3
0039,vap_other,2,1,-1,1
0039,vap_two,14,28,14,22
0039,vap_white,447,278,-169,346
0040,pop,1898,1728,-170,1796
0040,pop_aian,4,0,-4,2
0040,pop_asian,78,82,4,80
0040,pop_black,1370,1374,4,1372
0040,pop_hisp,79,81,2,80
0040,pop_nhpi,0,1,1,1
0040,pop_other,14,2,-12,7
0040,pop_two,68,40,-28,51
0040,pop_white,285,148,-137,203
0040,vap,1205,1127,-78,1158
0040,vap_aian,2,0,-2,1
0040,vap_asian,42,59,17,52
0040,vap_black,846,861,15,855
0040,vap_hisp,42,43,1,43
0040,vap_nhpi,0,1,1,1
0040,vap_other,4,0,-4,2
0040,vap_two,23,32,9,28
0040,vap_white,246,131,-115,177
0041,pop,1609,1628,19,1620
0041,pop_aian,1,0,-1,0
0041,pop_asian,48,90,42,73
0041,pop_black,1121,1218,97,1179
0041,pop_hisp,72,88,16,82
0041,pop_nhpi,0,0,0,0
0041,pop_other,1,5,4,3
0041,pop_two,35,55,20,47
0041,pop_white,330,172,-158,235
0041,vap,1142,1145,3,1144
0041,vap_aian,0,0,0,0
0041,vap_asian,32,62,30,50
0041,vap_black,750,825,75,795
0041,vap_hisp,41,60,19,52
0041,vap_nhpi,0,0,0,0
0041,vap_other,1,5,4,3
0041,vap_two,19,28,9,24
0041,vap_white,299,165,-134,219
0042,pop,1870,1898,28,1887
0042,pop_aian,7,12,5,10
0042,pop_asian,110,141,31,129
0042,pop_black,1256,1387,131,1335
0042,pop_hisp,82,88,6,86
0042,pop_nhpi,0,0,0,0
0042,pop_other,2,10,8,7
0042,pop_two,42,62,20,54
0042,pop_white,371,198,-173,267
0042,vap,1340,1343,3,1342
0042,vap_aian,7,4,-3,5
0042,vap_asian,64,100,36,86
0042,vap_black,859,960,101,920
0042,vap_hisp,50,48,-2,49
0042,vap_nhpi,0,0,0,0
0042,vap_other,2,8,6,6
0042,vap_two,20,43,23,34
0042,vap_white,338,180,-158,243
0043,pop,1552,628,-924,998
0043,pop_aian,7,2,-5,4
0043,pop_asian,33,67,34,53
0043,pop_black,1350,434,-916,800
0043,pop_hisp,31,37,6,35
0043,pop_nhpi,0,0,0,0
0043,pop_other,0,0,0,0
0043,pop_two,23,11,-12,16
0043,pop_white,108,77,-31,89
0043,vap,849,452,-397,611
0043,vap_aian,3,2,-1,2
0043,vap_asian,19,41,22,32
0043,vap_black,700,306,-394,464
0043,vap_hisp,17,23,6,21
0043,vap_nhpi,0,0,0,0
0043,vap_other,0,0,0,0
0043,vap_two,10,6,-4,8
0043,vap_white,100,74,-26,84
0044,pop,1912,1814,-98,1853
0044,pop_aian,9,3,-6,5
0044,pop_asian,84,65,-19,73
0044,pop_black,1370,1348,-22,1357
0044,pop_hisp,86,124,38,109
0044,pop_nhpi,0,0,0,0
0044,pop_other,0,14,14,8
0044,pop_two,47,58,11,54
0044,pop_white,316,202,-114,248
0044,vap,1301,1328,27,1317
0044,vap_aian,5,3,-2,4
0044,vap_asian,52,40,-12,45
0044,vap_black,880,989,109,945
0044,vap_hisp,56,70,14,64
0044,vap_nhpi,0,0,0,0
0044,vap_other,0,4,4,2
0044,vap_two,20,33,13,28
0044,vap_white,288,189,-99,229
0045,pop,2481,2249,-232,2342
0045,pop_aian,11,6,-5,8
0045,pop_asian,151,136,-15,142
0045,pop_black,1886,1762,-124,1812
0045,pop_hisp,82,79,-3,80
0045,pop_nhpi,0,1,1,1
0045,pop_other,5,20,15,14
0045,pop_two,61,61,0,61
0045,pop_white,285,184,-101,224
0045,vap,1563,1459,-104,1501
0045,vap_aian,11,6,-5,8
0045,vap_asian,92,88,-4,90
0045,vap_black,1121,1090,-31,1102
0045,vap_hisp,50,61,11,57
0045,vap_nhpi,0,1,1,1
0045,vap_other,3,15,12,10
0045,vap_two,27,25,-2,26
0045,vap_white,259,173,-86,207
0046,pop,1234,1141,-93,1178
0046,pop_aian,6,1,-5,3
0046,pop_asian,49,65,16,59
0046,pop_black,972,925,-47,944
0046,pop_hisp,70,38,-32,51
0046,pop_nhpi,0,0,0,0
0046,pop_other,4,1,-3,2
0046,pop_two,22,45,23,36
0046,pop_white,111,66,-45,84
0046,vap,794,780,-14,786
0046,vap_aian,3,1,-2,2
0046,vap_asian,27,45,18,38
0046,vap_black,601,613,12,608
0046,vap_hisp,43,28,-15,34
0046,vap_nhpi,0,0,0,0
0046,vap_other,1,0,-1,0
0046,vap_two,13,31,18,24
0046,vap_white,106,62,-44,80
0047,pop,2326,2308,-18,2315
0047,pop_aian,5,12,7,9
0047,pop_asian,94,151,57,128
0047,pop_black,1786,1760,-26,1770
0047,pop_hisp,97,102,5,100
0047,pop_nhpi,1,0,-1,0
0047,pop_other,6,11,5,9
0047,pop_two,67,82,15,76
0047,pop_white,270,190,-80,222
0047,vap,1549,1553,4,1551
0047,vap_aian,4,3,-1,3
0047,vap_asian,42,79,37,64
0047,vap_black,1166,1177,11,1173
0047,vap_hisp,58,64,6,62
0047,vap_nhpi,1,0,-1,0
0047,vap_other,3,7,4,5
0047,vap_two,33,47,14,41
0047,vap_white,242,176,-66,202
0048,pop,1030,1011,-19,1019
0048,pop_aian,3,2,-1,2
0048,pop_asian,45,31,-14,37
0048,pop_black,720,761,41,745
0048,pop_hisp,39,57,18,50
0048,pop_nhpi,0,0,0,0
0048,pop_other,1,2,1,2
0048,pop_two,24,17,-7,20
0048,pop_white,198,141,-57,164
0048,vap,740,744,4,742
0048,vap_aian,3,2,-1,2
0048,vap_asian,31,23,-8,26
0048,vap_black,489,529,40,513
0048,vap_hisp,24,43,19,35
0048,vap_nhpi,0,0,0,0
0048,vap_other,0,0,0,0
0048,vap_two,10,12,2,11
0048,vap_white,183,135,-48,154
0049,pop,1364,1355,-9,1359
0049,pop_aian,6,2,-4,4
0049,pop_asian,1,12,11,8
0049,pop_black,1102,1078,-24,1088
0049,pop_hisp,66,93,27,82
0049,pop_nhpi,0,1,1,1
0049,pop_other,0,10,10,6
0049,pop_two,35,66,31,54
0049,pop_white,154,93,-61,117
0049,vap,914,945,31,933
0049,vap_aian,4,2,-2,3
0049,vap_asian,1,10,9,6
0049,vap_black,713,759,46,741
0049,vap_hisp,38,49,11,45
0049,vap_nhpi,0,1,1,1
0049,vap_other,0,6,6,4
0049,vap_two,18,33,15,27
0049,vap_white,140,85,-55,107
0050,pop,1351,1288,-63,1313
0050,pop_aian,9,4,-5,6
0050,pop_asian,19,42,23,33
0050,pop_black,1158,1072,-86,1106
0050,pop_hisp,46,64,18,57
0050,pop_nhpi,1,1,0,1
0050,pop_other,4,2,-2,3
0050,pop_two,8,54,46,36
0050,pop_white,106,49,-57,72
0050,vap,903,862,-41,878
0050,vap_aian,6,4,-2,5
0050,vap_asian,12,27,15,21
0050,vap_black,750,709,-41,725
0050,vap_hisp,31,46,15,40
0050,vap_nhpi,1,0,-1,0
0050,vap_other,1,1,0,1
0050,vap_two,5,30,25,20
0050,vap_white,97,45,-52,66
0051,pop,1657,1513,-144,1571
0051,pop_aian,8,15,7,12
0051,pop_asian,1,10,9,6
0051,pop_black,1476,1269,-207,1352
0051,pop_hisp,64,72,8,69
0051,pop_nhpi,6,1,-5,3
0051,pop_other,0,17,17,10
0051,pop_two,29,50,21,42
0051,pop_white,73,79,6,77
0051,vap,1063,1033,-30,1045
0051,vap_aian,4,8,4,6
0051,vap_asian,0,9,9,5
0051,vap_black,945,870,-75,900
0051,vap_hisp,31,46,15,40
0051,vap_nhpi,4,0,-4,2
0051,vap_other,0,7,7,4
0051,vap_two,12,25,13,20
0051,vap_white,67,68,1,68
0052,pop,2089,1820,-269,1928
0052,pop_aian,12,1,-11,5
0052,pop_asian,1,13,12,8
0052,pop_black,1755,1567,-188,1642
0052,pop_hisp,69,67,-2,68
0052,pop_nhpi,1,0,-1,0
0052,pop_other,5,12,7,9
0052,pop_two,40,54,14,48
0052,pop_white,206,106,-100,146
0052,vap,1440,1292,-148,1351
0052,vap_aian,9,1,-8,4
0052,vap_asian,1,11,10,7
0052,vap_black,1182,1096,-86,1130
0052,vap_hisp,44,44,0,44
0052,vap_nhpi,1,0,-1,0
0052,vap_other,3,10,7,7
0052,vap_two,19,35,16,29
0052,vap_white,181,95,-86,129
0053,pop,992,883,-109,927
0053,pop_aian,2,0,-2,1
0053,pop_asian,2,6,4,4
0053,pop_black,825,746,-79,778
0053,pop_hisp,45,46,1,46
0053,pop_nhpi,0,0,0,0
0053,pop_other,0,0,0,0
0053,pop_two,23,33,10,29
0053,pop_white,95,52,-43,69
0053,vap,714,636,-78,667
0053,vap_aian,2,0,-2,1
0053,vap_asian,2,6,4,4
0053,vap_black,585,537,-48,556
0053,vap_hisp,23,26,3,25
0053,vap_nhpi,0,0,0,0
0053,vap_other,0,0,0,0
0053,vap_two,14,22,8,19
0053,vap_white,88,45,-43,62
0054,pop,1047,1051,4,1049
0054,pop_aian,0,2,2,1
0054,pop_asian,18,20,2,19
0054,pop_black,928,882,-46,900
0054,pop_hisp,26,33,7,30
0054,pop_nhpi,0,0,0,0
0054,pop_other,0,9,9,5
0054,pop_two,11,57,46,39
0054,pop_white,64,48,-16,54
0054,vap,732,783,51,763
0054,vap_aian,0,2,2,1
0054,vap_asian,8,13,5,11
0054,vap_black,639,668,29,656
0054,vap_hisp,18,18,0,18
0054,vap_nhpi,0,0,0,0
0054,vap_other,0,9,9,5
0054,vap_two,6,36,30,24
0054,vap_white,61,37,-24,47
0055,pop,2409,2439,30,2427
0055,pop_aian,7,3,-4,5
0055,pop_asian,33,62,29,50
0055,pop_black,1521,1514,-7,1517
0055,pop_hisp,115,184,69,156
0055,pop_nhpi,0,0,0,0
0055,pop_other,1,9,8,6
0055,pop_two,72,108,36,94
0055,pop_white,660,559,-101,599
0055,vap,1716,1767,51,1747
0055,vap_aian,7,1,-6,3
0055,vap_asian,22,38,16,32
0055,vap_black,1030,1047,17,1040
0055,vap_hisp,71,120,49,100
0055,vap_nhpi,0,0,0,0
0055,vap_other,1,9,8,6
0055,vap_two,31,59,28,48
0055,vap_white,554,493,-61,517
0056,pop,1427,1236,-191,1312
0056,pop_aian,2,4,2,3
0056,pop_asian,1,2,1,2
0056,pop_black,1320,1130,-190,1206
0056,pop_hisp,29,47,18,40
0056,pop_nhpi,0,0,0,0
0056,pop_other,1,3,2,2
0056,pop_two,34,14,-20,22
0056,pop_white,40,36,-4,38
0056,vap,963,892,-71,920
0056,vap_aian,2,1,-1,1
0056,vap_asian,1,2,1,2
0056,vap_black,887,835,-52,856
0056,vap_hisp,18,18,0,18
0056,vap_nhpi,0,0,0,0
0056,vap_other,1,1,0,1
0056,vap_two,19,9,-10,13
0056,vap_white,35,26,-9,30
0057,pop,1957,1756,-201,1836
0057,pop_aian,4,14,10,10
0057,pop_asian,2,6,4,4
0057,pop_black,1777,1568,-209,1652
0057,pop_hisp,67,80,13,75
0057,pop_nhpi,1,0,-1,0
0057,pop_other,0,6,6,4
0057,pop_two,44,31,-13,36
0057,pop_white,62,51,-11,55
0057,vap,1372,1293,-79,1325
0057,vap_aian,4,11,7,8
0057,vap_asian,2,6,4,4
0057,vap_black,1255,1156,-99,1196
0057,vap_hisp,34,51,17,44
0057,vap_nhpi,1,0,-1,0
0057,vap_other,0,2,2,1
0057,vap_two,16,18,2,17
0057,vap_white,60,49,-11,53
0058,pop,1373,1234,-139,1290
0058,pop_aian,2,2,0,2
0058,pop_asian,5,3,-2,4
0058,pop_black,1244,1077,-167,1144
0058,pop_hisp,36,65,29,53
0058,pop_nhpi,0,0,0,0
0058,pop_other,3,5,2,4
0058,pop_two,20,49,29,37
0058,pop_white,63,33,-30,45
0058,vap,989,916,-73,945
0058,vap_aian,1,2,1,2
0058,vap_asian,4,3,-1,3
0058,vap_black,894,812,-82,845
0058,vap_hisp,22,37,15,31
0058,vap_nhpi,0,0,0,0
0058,vap_other,1,4,3,3
0058,vap_two,12,29,17,22
0058,vap_white,55,29,-26,39
0059,pop,2412,2311,-101,2351
0059,pop_aian,3,5,2,4
0059,pop_asian,1,5,4,3
0059,pop_black,2272,2061,-211,2145
0059,pop_hisp,67,96,29,84
0059,pop_nhpi,0,0,0,0
0059,pop_other,1,1,0,1
0059,pop_two,25,74,49,54
0059,pop_white,43,69,26,59
0059,vap,1794,1715,-79,1747
0059,vap_aian,2,5,3,4
0059,vap_asian,1,3,2,2
0059,vap_black,1708,1535,-173,1604
0059,vap_hisp,35,73,38,58
0059,vap_nhpi,0,0,0,0
0059,vap_other,1,0,-1,0
0059,vap_two,9,46,37,31
0059,vap_white,38,53,15,47
0060,pop,1908,1608,-300,1728
0060,pop_aian,4,0,-4,2
0060,pop_asian,3,3,0,3
0060,pop_black,1773,1452,-321,1580
0060,pop_hisp,43,37,-6,39
0060,pop_nhpi,0,0,0,0
0060,pop_other,1,8,7,5
0060,pop_two,44,69,25,59
0060,pop_white,40,39,-1,39
0060,vap,1363,1161,-202,1242
0060,vap_aian,3,0,-3,1
0060,vap_asian,3,3,0,3
0060,vap_black,1278,1045,-233,1138
0060,vap_hisp,19,25,6,23
0060,vap_nhpi,0,0,0,0
0060,vap_other,0,8,8,5
0060,vap_two,23,49,26,39
0060,vap_white,37,31,-6,33
0061,pop,1656,1589,-67,1616
0061,pop_aian,5,4,-1,4
0061,pop_asian,0,4,4,2
0061,pop_black,1553,1420,-133,1473
0061,pop_hisp,41,56,15,50
0061,pop_nhpi,0,0,0,0
0061,pop_other,1,8,7,5
0061,pop_two,20,61,41,45
0061,pop_white,36,36,0,36
0061,vap,1165,1139,-26,1149
0061,vap_aian,3,4,1,4
0061,vap_asian,0,3,3,2
0061,vap_black,1096,1024,-72,1053
0061,vap_hisp,21,31,10,27
0061,vap_nhpi,0,0,0,0
0061,vap_other,1,8,7,5
0061,vap_two,13,38,25,28
0061,vap_white,31,31,0,31
0062,pop,1638,1330,-308,1453
0062,pop_aian,4,3,-1,3
0062,pop_asian,1,10,9,6
0062,pop_black,1496,1213,-283,1326
0062,pop_hisp,35,45,10,41
0062,pop_nhpi,0,0,0,0
0062,pop_other,2,7,5,5
0062,pop_two,55,26,-29,38
0062,pop_white,45,26,-19,34
0062,vap,1113,978,-135,1032
0062,vap_aian,2,2,0,2
0062,vap_asian,1,10,9,6
0062,vap_black,1031,886,-145,944
0062,vap_hisp,18,24,6,22
0062,vap_nhpi,0,0,0,0
0062,vap_other,0,6,6,4
0062,vap_two,19,25,6,23
0062,vap_white,42,25,-17,32
0063,pop,1560,1475,-85,1509
0063,pop_aian,1,1,0,1
0063,pop_asian,11,1,-10,5
0063,pop_black,1464,1350,-114,1396
0063,pop_hisp,29,54,25,44
0063,pop_nhpi,0,0,0,0
0063,pop_other,2,9,7,6
0063,pop_two,22,29,7,26
0063,pop_white,31,31,0,31
0063,vap,1051,1039,-12,1044
0063,vap_aian,0,0,0,0
0063,vap_asian,10,1,-9,5
0063,vap_black,987,952,-35,966
0063,vap_hisp,15,32,17,25
0063,vap_nhpi,0,0,0,0
0063,vap_other,2,9,7,6
0063,vap_two,11,17,6,15
0063,vap_white,26,28,2,27
0064,pop,3101,2887,-214,2973
0064,pop_aian,16,7,-9,11
0064,pop_asian,22,12,-10,16
0064,pop_black,2720,2510,-210,2594
0064,pop_hisp,85,171,86,137
0064,pop_nhpi,0,0,0,0
0064,pop_other,6,4,-2,5
0064,pop_two,78,93,15,87
0064,pop_white,174,90,-84,124
0064,vap,2005,1982,-23,1991
0064,vap_aian,7,5,-2,6
0064,vap_asian,14,12,-2,13
0064,vap_black,1743,1711,-32,1724
0064,vap_hisp,49,107,58,84
0064,vap_nhpi,0,0,0,0
0064,vap_other,1,3,2,2
0064,vap_two,29,58,29,46
0064,vap_white,162,86,-76,116
0065,pop,2091,2096,5,2094
0065,pop_aian,4,7,3,6
0065,pop_asian,15,28,13,23
0065,pop_black,1893,1783,-110,1827
0065,pop_hisp,47,118,71,90
0065,pop_nhpi,0,0,0,0
0065,pop_other,5,2,-3,3
0065,pop_two,27,91,64,65
0065,pop_white,100,67,-33,80
0065,vap,1431,1469,38,1454
0065,vap_aian,4,6,2,5
0065,vap_asian,9,16,7,13
0065,vap_black,1287,1249,-38,1264
0065,vap_hisp,30,78,48,59
0065,vap_nhpi,0,0,0,0
0065,vap_other,0,2,2,1
0065,vap_two,12,57,45,39
0065,vap_white,89,61,-28,72
0066,pop,1521,1421,-100,1461
0066,pop_aian,3,0,-3,1
0066,pop_asian,3,13,10,9
0066,pop_black,1422,1320,-102,1361
0066,pop_hisp,23,22,-1,22
0066,pop_nhpi,0,0,0,0
0066,pop_other,0,9,9,5
0066,pop_two,40,22,-18,29
0066,pop_white,30,35,5,33
0066,vap,904,860,-44,878
0066,vap_aian,2,0,-2,1
0066,vap_asian,3,10,7,7
0066,vap_black,845,779,-66,805
0066,vap_hisp,11,8,-3,9
0066,vap_nhpi,0,0,0,0
0066,vap_other,0,9,9,5
0066,vap_two,15,19,4,17
0066,vap_white,28,35,7,32
0067,pop,1397,1396,-1,1396
0067,pop_aian,6,10,4,8
0067,pop_asian,21,36,15,30
0067,pop_black,1177,1134,-43,1151
0067,pop_hisp,44,78,34,64
0067,pop_nhpi,1,0,-1,0
0067,pop_other,3,5,2,4
0067,pop_two,24,63,39,47
0067,pop_white,121,70,-51,90
0067,vap,925,922,-3,923
0067,vap_aian,1,8,7,5
0067,vap_asian,10,11,1,11
0067,vap_black,763,757,-6,759
0067,vap_hisp,25,49,24,39
0067,vap_nhpi,1,0,-1,0
0067,vap_other,0,5,5,3
0067,vap_two,9,32,23,23
0067,vap_white,116,60,-56,82
0068,pop,2369,2276,-93,2313
0068,pop_aian,14,0,-14,6
0068,pop_asian,153,212,59,188
0068,pop_black,1804,1728,-76,1758
0068,pop_hisp,96,94,-2,95
0068,pop_nhpi,0,2,2,1
0068,pop_other,0,12,12,7
0068,pop_two,49,68,19,60
0068,pop_white,253,160,-93,197
0068,vap,1619,1623,4,1621
0068,vap_aian,11,0,-11,4
0068,vap_asian,99,143,44,125
0068,vap_black,1187,1226,39,1210
0068,vap_hisp,66,65,-1,65
0068,vap_nhpi,0,2,2,1
0068,vap_other,0,6,6,4
0068,vap_two,20,31,11,27
0068,vap_white,236,150,-86,184
0069,pop,1884,1710,-174,1780
0069,pop_aian,7,5,-2,6
0069,pop_asian,18,41,23,32
0069,pop_black,1555,1473,-82,1506
0069,pop_hisp,61,49,-12,54
0069,pop_nhpi,0,0,0,0
0069,pop_other,2,9,7,6
0069,pop_two,45,39,-6,41
0069,pop_white,195,94,-101,134
0069,vap,1300,1214,-86,1248
0069,vap_aian,4,3,-1,3
0069,vap_asian,17,20,3,19
0069,vap_black,1050,1036,-14,1042
0069,vap_hisp,31,33,2,32
0069,vap_nhpi,0,0,0,0
0069,vap_other,2,4,2,3
0069,vap_two,22,25,3,24
0069,vap_white,174,93,-81,125
0070,pop,2376,2195,-181,2267
0070,pop_aian,1,5,4,3
0070,pop_asian,67,98,31,86
0070,pop_black,1859,1793,-66,1819
0070,pop_hisp,122,89,-33,102
0070,pop_nhpi,0,0,0,0
0070,pop_other,5,2,-3,3
0070,pop_two,76,51,-25,61
0070,pop_white,246,157,-89,193
0070,vap,1640,1605,-35,1619
0070,vap_aian,1,5,4,3
0070,vap_asian,47,54,7,51
0070,vap_black,1262,1314,52,1293
0070,vap_hisp,66,57,-9,61
0070,vap_nhpi,0,0,0,0
0070,vap_other,4,2,-2,3
0070,vap_two,36,29,-7,32
0070,vap_white,224,144,-80,176
0071,pop,1408,1346,-62,1371
0071,pop_aian,6,0,-6,2
0071,pop_asian,129,101,-28,112
0071,pop_black,1040,1054,14,1048
0071,pop_hisp,37,35,-2,36
0071,pop_nhpi,0,0,0,0
0071,pop_other,2,12,10,8
0071,pop_two,33,34,1,34
0071,pop_white,161,110,-51,130
0071,vap,963,987,24,977
0071,vap_aian,4,0,-4,2
0071,vap_asian,78,66,-12,71
0071,vap_black,704,761,57,738
0071,vap_hisp,21,23,2,22
0071,vap_nhpi,0,0,0,0
0071,vap_other,0,12,12,7
0071,vap_two,10,22,12,17
0071,vap_white,146,103,-43,120
0072,pop,1941,1877,-64,1903
0072,pop_aian,3,11,8,8
0072,pop_asian,201,173,-28,184
0072,pop_black,1367,1442,75,1412
0072,pop_hisp,46,43,-3,44
0072,pop_nhpi,0,0,0,0
0072,pop_other,0,5,5,3
0072,pop_two,59,54,-5,56
0072,pop_white,265,149,-116,195
0072,vap,1298,1364,66,1338
0072,vap_aian,3,8,5,6
0072,vap_asian,111,130,19,122
0072,vap_black,890,1020,130,968
0072,vap_hisp,31,26,-5,28
0072,vap_nhpi,0,0,0,0
0072,vap_other,0,0,0,0
0072,vap_two,29,34,5,32
0072,vap_white,234,146,-88,181
0073,pop,2073,1935,-138,1990
0073,pop_aian,9,10,1,10
0073,pop_asian,213,231,18,224
0073,pop_black,1401,1306,-95,1344
0073,pop_hisp,66,84,18,77
0073,pop_nhpi,0,0,0,0
0073,pop_other,1,2,1,2
0073,pop_two,33,71,38,56
0073,pop_white,350,231,-119,279
0073,vap,1469,1444,-25,1454
0073,vap_aian,6,9,3,8
0073,vap_asian,147,150,3,149
0073,vap_black,929,975,46,957
0073,vap_hisp,41,55,14,49
0073,vap_nhpi,0,0,0,0
0073,vap_other,1,0,-1,0
0073,vap_two,17,36,19,28
0073,vap_white,328,219,-109,263
0074,pop,1235,1156,-79,1188
0074,pop_aian,4,2,-2,3
0074,pop_asian,71,97,26,87
0074,pop_black,866,888,22,879
0074,pop_hisp,59,35,-24,45
0074,pop_nhpi,1,0,-1,0
0074,pop_other,0,0,0,0
0074,pop_two,27,30,3,29
0074,pop_white,207,104,-103,145
0074,vap,878,888,10,884
0074,vap_aian,3,2,-1,2
0074,vap_asian,45,61,16,55
0074,vap_black,602,686,84,652
0074,vap_hisp,37,24,-13,29
0074,vap_nhpi,1,0,-1,0
0074,vap_other,0,0,0,0
0074,vap_two,9,17,8,14
0074,vap_white,182,98,-84,132
0075,pop,1309,1396,87,1361
0075,pop_aian,13,4,-9,8
0075,pop_asian,63,137,74,107
0075,pop_black,606,816,210,732
0075,pop_hisp,33,64,31,52
0075,pop_nhpi,3,0,-3,1
0075,pop_other,5,0,-5,2
0075,pop_two,62,57,-5,59
0075,pop_white,524,318,-206,400
0075,vap,955,1051,96,1013
0075,vap_aian,9,4,-5,6
0075,vap_asian,36,78,42,61
0075,vap_black,403,606,203,525
0075,vap_hisp,17,37,20,29
0075,vap_nhpi,3,0,-3,1
0075,vap_other,4,0,-4,2
0075,vap_two,28,33,5,31
0075,vap_white,455,293,-162,358
0076,pop,1489,1476,-13,1481
0076,pop_aian,8,3,-5,5
0076,pop_asian,99,101,2,100
0076,pop_black,1007,1063,56,1041
0076,pop_hisp,38,93,55,71
0076,pop_nhpi,0,0,0,0
0076,pop_other,1,8,7,5
0076,pop_two,51,39,-12,44
0076,pop_white,285,169,-116,215
0076,vap,1001,1028,27,1017
0076,vap_aian,6,0,-6,2
0076,vap_asian,58,76,18,69
0076,vap_black,645,725,80,693
0076,vap_hisp,25,63,38,48
0076,vap_nhpi,0,0,0,0
0076,vap_other,1,3,2,2
0076,vap_two,18,22,4,20
0076,vap_white,247,139,-108,182
0077,pop,1400,1350,-50,1370
0077,pop_aian,5,2,-3,3
0077,pop_asian,159,169,10,165
0077,pop_black,781,874,93,837
0077,pop_hisp,56,53,-3,54
0077,pop_nhpi,0,0,0,0
0077,pop_other,2,15,13,10
0077,pop_two,26,64,38,49
0077,pop_white,371,173,-198,252
0077,vap,1000,970,-30,982
0077,vap_aian,4,0,-4,2
0077,vap_asian,85,106,21,98
0077,vap_black,526,620,94,582
0077,vap_hisp,30,39,9,35
0077,vap_nhpi,0,0,0,0
0077,vap_other,0,7,7,4
0077,vap_two,10,37,27,26
0077,vap_white,345,161,-184,235
0078,pop,2437,2444,7,2441
0078,pop_aian,8,4,-4,6
0078,pop_asian,113,259,146,201
0078,pop_black,1529,1628,99,1588
0078,pop_hisp,104,87,-17,94
0078,pop_nhpi,0,1,1,1
0078,pop_other,1,11,10,7
0078,pop_two,119,96,-23,105
0078,pop_white,563,358,-205,440
0078,vap,1619,1680,61,1656
0078,vap_aian,8,0,-8,3
0078,vap_asian,60,166,106,124
0078,vap_black,960,1085,125,1035
0078,vap_hisp,51,50,-1,50
0078,vap_nhpi,0,1,1,1
0078,vap_other,0,5,5,3
0078,vap_two,40,51,11,47
0078,vap_white,500,322,-178,393
0079,pop,2227,2246,19,2238
0079,pop_aian,15,6,-9,10
0079,pop_asian,63,113,50,93
0079,pop_black,1235,1434,199,1354
0079,pop_hisp,117,86,-31,98
0079,pop_nhpi,0,0,0,0
0079,pop_other,3,6,3,5
0079,pop_two,78,81,3,80
0079,pop_white,716,520,-196,598
0079,vap,1589,1697,108,1654
0079,vap_aian,12,4,-8,7
0079,vap_asian,37,61,24,51
0079,vap_black,809,1056,247,957
0079,vap_hisp,60,51,-9,55
0079,vap_nhpi,0,0,0,0
0079,vap_other,2,2,0,2
0079,vap_two,26,49,23,40
0079,vap_white,643,474,-169,542
0080,pop,2935,3050,115,3004
0080,pop_aian,10,8,-2,9
0080,pop_asian,121,128,7,125
0080,pop_black,944,1397,453,1216
0080,pop_hisp,87,144,57,121
0080,pop_nhpi,1,0,-1,0
0080,pop_other,7,20,13,15
0080,pop_two,104,141,37,126
0080,pop_white,1661,1212,-449,1392
0080,vap,2366,2379,13,2374
0080,vap_aian,8,6,-2,7
0080,vap_asian,80,86,6,84
0080,vap_black,674,986,312,861
0080,vap_hisp,51,88,37,73
0080,vap_nhpi,1,0,-1,0
0080,vap_other,3,15,12,10
0080,vap_two,58,83,25,73
0080,vap_white,1491,1115,-376,1265
0081,pop,1041,1098,57,1075
0081,pop_aian,9,5,-4,7
0081,pop_asian,19,36,17,29
0081,pop_black,124,211,87,176
0081,pop_hisp,42,89,47,70
0081,pop_nhpi,0,0,0,0
0081,pop_other,2,6,4,4
0081,pop_two,10,61,51,41
0081,pop_white,835,690,-145,748
0081,vap,797,849,52,828
0081,vap_aian,6,3,-3,4
0081,vap_asian,16,32,16,26
0081,vap_black,85,134,49,114
0081,vap_hisp,26,51,25,41
0081,vap_nhpi,0,0,0,0
0081,vap_other,0,6,6,4
0081,vap_two,4,32,28,21
0081,vap_white,660,591,-69,619
0082,pop,1318,1299,-19,1307
0082,pop_aian,7,6,-1,6
0082,pop_asian,26,24,-2,25
0082,pop_black,55,141,86,107
0082,pop_hisp,53,91,38,76
0082,pop_nhpi,0,1,1,1
0082,pop_other,0,1,1,1
0082,pop_two,18,71,53,50
0082,pop_white,1159,964,-195,1042
0082,vap,1009,1026,17,1019
0082,vap_aian,5,5,0,5
0082,vap_asian,18,24,6,22
0082,vap_black,45,95,50,75
0082,vap_hisp,26,66,40,50
0082,vap_nhpi,0,0,0,0
0082,vap_other,0,1,1,1
0082,vap_two,7,44,37,29
0082,vap_white,908,791,-117,838
0083,pop,1713,1698,-15,1704
0083,pop_aian,5,3,-2,4
0083,pop_asian,47,57,10,53
0083,pop_black,155,360,205,278
0083,pop_hisp,111,110,-1,110
0083,pop_nhpi,1,5,4,3
0083,pop_other,2,4,2,3
0083,pop_two,51,111,60,87
0083,pop_white,1341,1048,-293,1165
0083,vap,1295,1325,30,1313
0083,vap_aian,5,1,-4,3
0083,vap_asian,34,48,14,42
0083,vap_black,108,258,150,198
0083,vap_hisp,61,75,14,69
0083,vap_nhpi,1,5,4,3
0083,vap_other,0,1,1,1
0083,vap_two,12,51,39,35
0083,vap_white,1074,886,-188,961
0084,pop,1201,1208,7,1205
0084,pop_aian,1,5,4,3
0084,pop_asian,27,32,5,30
0084,pop_black,123,203,80,171
0084,pop_hisp,74,103,29,91
0084,pop_nhpi,0,0,0,0
0084,pop_other,2,9,7,6
0084,pop_two,29,85,56,63
0084,pop_white,945,771,-174,841
0084,vap,924,943,19,935
0084,vap_aian,1,5,4,3
0084,vap_asian,18,22,4,20
0084,vap_black,77,143,66,117
0084,vap_hisp,37,67,30,55
0084,vap_nhpi,0,0,0,0
0084,vap_other,1,7,6,5
0084,vap_two,6,51,45,33
0084,vap_white,784,648,-136,702
0085,pop,1532,1425,-107,1468
0085,pop_aian,6,10,4,8
0085,pop_asian,32,31,-1,31
0085,pop_black,85,101,16,95
0085,pop_hisp,50,69,19,61
0085,pop_nhpi,4,0,-4,2
0085,pop_other,1,12,11,8
0085,pop_two,35,60,25,50
0085,pop_white,1319,1142,-177,1213
0085,vap,1215,1168,-47,1187
0085,vap_aian,5,10,5,8
0085,vap_asian,25,26,1,26
0085,vap_black,68,76,8,73
0085,vap_hisp,37,51,14,45
0085,vap_nhpi,4,0,-4,2
0085,vap_other,0,9,9,5
0085,vap_two,17,35,18,28
0085,vap_white,1059,961,-98,1000
0086,pop,1384,1361,-23,1370
0086,pop_aian,4,1,-3,2
0086,pop_asian,37,27,-10,31
0086,pop_black,106,177,71,149
0086,pop_hisp,27,81,54,59
0086,pop_nhpi,1,0,-1,0
0086,pop_other,2,2,0,2
0086,pop_two,33,81,48,62
0086,pop_white,1174,992,-182,1065
0086,vap,1110,1105,-5,1107
0086,vap_aian,4,1,-3,2
0086,vap_asian,28,20,-8,23
0086,vap_black,83,128,45,110
0086,vap_hisp,17,48,31,36
0086,vap_nhpi,1,0,-1,0
0086,vap_other,2,2,0,2
0086,vap_two,14,47,33,34
0086,vap_white,961,859,-102,900
0087,pop,935,977,42,960
0087,pop_aian,3,0,-3,1
0087,pop_asian,14,14,0,14
0087,pop_black,161,190,29,178
0087,pop_hisp,26,59,33,46
0087,pop_nhpi,0,0,0,0
0087,pop_other,0,1,1,1
0087,pop_two,29,45,16,39
0087,pop_white,702,668,-34,682
0087,vap,747,740,-7,743
0087,vap_aian,3,0,-3,1
0087,vap_asian,12,13,1,13
0087,vap_black,112,117,5,115
0087,vap_hisp,12,33,21,25
0087,vap_nhpi,0,0,0,0
0087,vap_other,0,1,1,1
0087,vap_two,15,20,5,18
0087,vap_white,593,556,-37,571
0088,pop,1324,1309,-15,1315
0088,pop_aian,9,5,-4,7
0088,pop_asian,7,24,17,17
0088,pop_black,208,365,157,302
0088,pop_hisp,74,72,-2,73
0088,pop_nhpi,3,0,-3,1
0088,pop_other,6,12,6,10
0088,pop_two,36,89,53,68
0088,pop_white,981,742,-239,838
0088,vap,995,1039,44,1021
0088,vap_aian,6,5,-1,5
0088,vap_asian,5,17,12,12
0088,vap_black,144,268,124,218
0088,vap_hisp,41,54,13,49
0088,vap_nhpi,2,0,-2,1
0088,vap_other,2,11,9,7
0088,vap_two,12,36,24,26
0088,vap_white,783,648,-135,702
0089,pop,1856,1891,35,1877
0089,pop_aian,10,2,-8,5
0089,pop_asian,24,75,51,55
0089,pop_black,458,734,276,624
0089,pop_hisp,89,104,15,98
0089,pop_nhpi,0,3,3,2
0089,pop_other,5,34,29,22
0089,pop_two,86,118,32,105
0089,pop_white,1184,821,-363,966
0089,vap,1404,1383,-21,1391
0089,vap_aian,7,2,-5,4
0089,vap_asian,20,50,30,38
0089,vap_black,325,499,174,429
0089,vap_hisp,45,64,19,56
0089,vap_nhpi,0,3,3,2
0089,vap_other,4,24,20,16
0089,vap_two,34,48,14,42
0089,vap_white,969,693,-276,803
0090,pop,1786,1767,-19,1775
0090,pop_aian,10,5,-5,7
0090,pop_asian,120,140,20,132
0090,pop_black,588,786,198,707
0090,pop_hisp,79,115,36,101
0090,pop_nhpi,0,4,4,2
0090,pop_other,4,9,5,7
0090,pop_two,37,76,39,60
0090,pop_white,948,632,-316,758
0090,vap,1341,1382,41,1366
0090,vap_aian,7,3,-4,5
0090,vap_asian,67,92,25,82
0090,vap_black,427,596,169,528
0090,vap_hisp,50,81,31,69
0090,vap_nhpi,0,4,4,2
0090,vap_other,3,4,1,4
0090,vap_two,13,35,22,26
0090,vap_white,774,567,-207,650
0091,pop,2632,2732,100,2692
0091,pop_aian,7,8,1,8
0091,pop_asian,48,131,83,98
0091,pop_black,1833,2057,224,1967
0091,pop_hisp,112,89,-23,98
0091,pop_nhpi,1,0,-1,0
0091,pop_other,5,13,8,10
0091,pop_two,67,113,46,95
0091,pop_white,559,321,-238,416
0091,vap,1912,1998,86,1964
0091,vap_aian,4,8,4,6
0091,vap_asian,30,87,57,64
0091,vap_black,1283,1480,197,1401
0091,vap_hisp,68,55,-13,60
0091,vap_nhpi,1,0,-1,0
0091,vap_other,4,6,2,5
0091,vap_two,26,62,36,48
0091,vap_white,496,300,-196,378
0092,pop,2437,2455,18,2448
0092,pop_aian,9,4,-5,6
0092,pop_asian,17,18,1,18
0092,pop_black,776,1008,232,915
0092,pop_hisp,124,147,23,138
0092,pop_nhpi,1,1,0,1
0092,pop_other,6,7,1,7
0092,pop_two,105,121,16,115
0092,pop_white,1399,1149,-250,1249
0092,vap,1827,1828,1,1828
0092,vap_aian,8,2,-6,4
0092,vap_asian,14,12,-2,13
0092,vap_black,557,708,151,648
0092,vap_hisp,70,90,20,82
0092,vap_nhpi,1,1,0,1
0092,vap_other,2,7,5,5
0092,vap_two,39,62,23,53
0092,vap_white,1136,946,-190,1022
0093,pop,1018,936,-82,969
0093,pop_aian,2,3,1,3
0093,pop_asian,14,18,4,16
0093,pop_black,147,110,-37,125
0093,pop_hisp,38,48,10,44
0093,pop_nhpi,2,1,-1,1
0093,pop_other,0,7,7,4
0093,pop_two,23,45,22,36
0093,pop_white,792,704,-88,739
0093,vap,735,759,24,749
0093,vap_aian,1,3,2,2
0093,vap_asian,11,12,1,12
0093,vap_black,110,94,-16,100
0093,vap_hisp,21,29,8,26
0093,vap_nhpi,1,1,0,1
0093,vap_other,0,3,3,2
0093,vap_two,6,24,18,17
0093,vap_white,585,593,8,590
0094,pop,1293,1166,-127,1217
0094,pop_aian,4,1,-3,2
0094,pop_asian,52,37,-15,43
0094,pop_black,924,958,34,944
0094,pop_hisp,58,44,-14,50
0094,pop_nhpi,0,0,0,0
0094,pop_other,0,9,9,5
0094,pop_two,38,30,-8,33
0094,pop_white,217,87,-130,139
0094,vap,979,873,-106,915
0094,vap_aian,4,1,-3,2
0094,vap_asian,31,26,-5,28
0094,vap_black,699,721,22,712
0094,vap_hisp,39,24,-15,30
0094,vap_nhpi,0,0,0,0
0094,vap_other,0,9,9,5
0094,vap_two,20,17,-3,18
0094,vap_white,186,75,-111,119
0095,pop,1086,1095,9,1091
0095,pop_aian,6,0,-6,2
0095,pop_asian,20,41,21,33
0095,pop_black,804,846,42,829
0095,pop_hisp,56,57,1,57
0095,pop_nhpi,0,0,0,0
0095,pop_other,4,4,0,4
0095,pop_two,22,42,20,34
0095,pop_white,174,105,-69,133
0095,vap,759,786,27,775
0095,vap_aian,3,0,-3,1
0095,vap_asian,10,23,13,18
0095,vap_black,538,608,70,580
0095,vap_hisp,29,33,4,31
0095,vap_nhpi,0,0,0,0
0095,vap_other,3,2,-1,2
0095,vap_two,13,26,13,21
0095,vap_white,163,94,-69,122
0096,pop,1811,1757,-54,1779
0096,pop_aian,6,3,-3,4
0096,pop_asian,17,23,6,21
0096,pop_black,1121,1166,45,1148
0096,pop_hisp,71,97,26,87
0096,pop_nhpi,0,1,1,1
0096,pop_other,8,15,7,12
0096,pop_two,51,54,3,53
0096,pop_white,537,398,-139,454
0096,vap,1300,1357,57,1334
0096,vap_aian,6,2,-4,4
0096,vap_asian,12,15,3,14
0096,vap_black,792,902,110,858
0096,vap_hisp,43,61,18,54
0096,vap_nhpi,0,1,1,1
0096,vap_other,3,6,3,5
0096,vap_two,26,36,10,32
0096,vap_white,418,334,-84,368
0097,pop,1769,1677,-92,1714
0097,pop_aian,1,2,1,2
0097,pop_asian,15,31,16,25
0097,pop_black,954,925,-29,937
0097,pop_hisp,61,73,12,68
0097,pop_nhpi,0,2,2,1
0097,pop_other,2,24,22,15
0097,pop_two,42,61,19,53
0097,pop_white,694,559,-135,613
0097,vap,1213,1198,-15,1204
0097,vap_aian,1,2,1,2
0097,vap_asian,10,22,12,17
0097,vap_black,673,684,11,680
0097,vap_hisp,40,46,6,44
0097,vap_nhpi,0,2,2,1
0097,vap_other,2,16,14,10
0097,vap_two,19,34,15,28
0097,vap_white,468,392,-76,422
0098,pop,1060,1042,-18,1049
0098,pop_aian,5,4,-1,4
0098,pop_asian,10,14,4,12
0098,pop_black,880,857,-23,866
0098,pop_hisp,26,50,24,40
0098,pop_nhpi,0,2,2,1
0098,pop_other,5,5,0,5
0098,pop_two,23,38,15,32
0098,pop_white,111,72,-39,88
0098,vap,778,833,55,811
0098,vap_aian,3,3,0,3
0098,vap_asian,8,10,2,9
0098,vap_black,633,697,64,671
0098,vap_hisp,16,33,17,26
0098,vap_nhpi,0,2,2,1
0098,vap_other,3,4,1,4
0098,vap_two,14,25,11,21
0098,vap_white,101,59,-42,76
0099,pop,2108,2012,-96,2050
0099,pop_aian,1,6,5,4
0099,pop_asian,16,38,22,29
0099,pop_black,1622,1538,-84,1572
0099,pop_hisp,79,98,19,90
0099,pop_nhpi,0,0,0,0
0099,pop_other,4,12,8,9
0099,pop_two,56,76,20,68
0099,pop_white,330,244,-86,278
0099,vap,1460,1436,-24,1446
0099,vap_aian,0,4,4,2
0099,vap_asian,12,24,12,19
0099,vap_black,1120,1105,-15,1111
0099,vap_hisp,40,63,23,54
0099,vap_nhpi,0,0,0,0
0099,vap_other,3,12,9,8
0099,vap_two,32,55,23,46
0099,vap_white,253,173,-80,205
0100,pop,1300,1233,-67,1260
0100,pop_aian,1,5,4,3
0100,pop_asian,3,14,11,10
0100,pop_black,1175,1073,-102,1114
0100,pop_hisp,24,47,23,38
0100,pop_nhpi,0,2,2,1
0100,pop_other,0,6,6,4
0100,pop_two,21,30,9,26
0100,pop_white,76,56,-20,64
0100,vap,971,927,-44,945
0100,vap_aian,1,4,3,3
0100,vap_asian,3,12,9,8
0100,vap_black,864,815,-49,835
0100,vap_hisp,17,22,5,20
0100,vap_nhpi,0,2,2,1
0100,vap_other,0,4,4,2
0100,vap_two,13,15,2,14
0100,vap_white,73,53,-20,61
0101,pop,1891,1857,-34,1871
0101,pop_aian,3,7,4,5
0101,pop_asian,21,16,-5,18
0101,pop_black,1719,1665,-54,1687
0101,pop_hisp,42,66,24,56
0101,pop_nhpi,0,0,0,0
0101,pop_other,0,8,8,5
0101,pop_two,41,49,8,46
0101,pop_white,65,46,-19,54
0101,vap,1333,1366,33,1353
0101,vap_aian,3,5,2,4
0101,vap_asian,13,10,-3,11
0101,vap_black,1209,1229,20,1221
0101,vap_hisp,24,44,20,36
0101,vap_nhpi,0,0,0,0
0101,vap_other,0,5,5,3
0101,vap_two,21,32,11,28
0101,vap_white,63,41,-22,50
0102,pop,2290,2219,-71,2247
0102,pop_aian,9,11,2,10
0102,pop_asian,3,34,31,22
0102,pop_black,1964,1824,-140,1880
0102,pop_hisp,58,88,30,76
0102,pop_nhpi,0,0,0,0
0102,pop_other,3,10,7,7
0102,pop_two,56,81,25,71
0102,pop_white,197,171,-26,181
0102,vap,1614,1652,38,1637
0102,vap_aian,7,11,4,9
0102,vap_asian,3,21,18,14
0102,vap_black,1382,1378,-4,1380
0102,vap_hisp,29,59,30,47
0102,vap_nhpi,0,0,0,0
0102,vap_other,1,9,8,6
0102,vap_two,30,44,14,38
0102,vap_white,162,130,-32,143
0103,pop,3080,2801,-279,2913
0103,pop_aian,14,1,-13,6
0103,pop_asian,22,44,22,35
0103,pop_black,2640,2345,-295,2463
0103,pop_hisp,92,117,25,107
0103,pop_nhpi,0,0,0,0
0103,pop_other,2,15,13,10
0103,pop_two,59,70,11,66
0103,pop_white,251,209,-42,226
0103,vap,2080,2005,-75,2035
0103,vap_aian,8,1,-7,4
0103,vap_asian,18,30,12,25
0103,vap_black,1762,1653,-109,1697
0103,vap_hisp,54,84,30,72
0103,vap_nhpi,0,0,0,0
0103,vap_other,1,7,6,5
0103,vap_two,25,48,23,39
0103,vap_white,212,182,-30,194
0104,pop,2929,2594,-335,2728
0104,pop_aian,7,5,-2,6
0104,pop_asian,39,10,-29,22
0104,pop_black,2663,2322,-341,2458
0104,pop_hisp,81,98,17,91
0104,pop_nhpi,0,0,0,0
0104,pop_other,2,24,22,15
0104,pop_two,57,71,14,65
0104,pop_white,80,64,-16,70
0104,vap,1949,1824,-125,1874
0104,vap_aian,4,5,1,5
0104,vap_asian,21,8,-13,13
0104,vap_black,1769,1628,-141,1684
0104,vap_hisp,54,71,17,64
0104,vap_nhpi,0,0,0,0
0104,vap_other,1,19,18,12
0104,vap_two,28,35,7,32
0104,vap_white,72,58,-14,64
0105,pop,1583,1202,-381,1354
0105,pop_aian,3,0,-3,1
0105,pop_asian,14,4,-10,8
0105,pop_black,1460,1084,-376,1234
0105,pop_hisp,33,29,-4,31
0105,pop_nhpi,0,2,2,1
0105,pop_other,0,6,6,4
0105,pop_two,43,53,10,49
0105,pop_white,30,24,-6,26
0105,vap,989,848,-141,904
0105,vap_aian,3,0,-3,1
0105,vap_asian,14,0,-14,6
0105,vap_black,915,774,-141,830
0105,vap_hisp,17,15,-2,16
0105,vap_nhpi,0,2,2,1
0105,vap_other,0,3,3,2
0105,vap_two,14,33,19,25
0105,vap_white,26,21,-5,23
0106,pop,1295,1106,-189,1182
0106,pop_aian,1,2,1,2
0106,pop_asian,19,12,-7,15
0106,pop_black,1202,998,-204,1080
0106,pop_hisp,35,51,16,45
0106,pop_nhpi,0,0,0,0
0106,pop_other,0,6,6,4
0106,pop_two,26,24,-2,25
0106,pop_white,12,13,1,13
0106,vap,831,722,-109,766
0106,vap_aian,1,2,1,2
0106,vap_asian,7,2,-5,4
0106,vap_black,779,659,-120,707
0106,vap_hisp,22,29,7,26
0106,vap_nhpi,0,0,0,0
0106,vap_other,0,3,3,2
0106,vap_two,11,16,5,14
0106,vap_white,11,11,0,11
0107,pop,1659,1568,-91,1604
0107,pop_aian,5,4,-1,4
0107,pop_asian,1,8,7,5
0107,pop_black,1560,1444,-116,1490
0107,pop_hisp,38,25,-13,30
0107,pop_nhpi,0,0,0,0
0107,pop_other,3,7,4,5
0107,pop_two,23,48,25,38
0107,pop_white,29,32,3,31
0107,vap,1162,1141,-21,1149
0107,vap_aian,3,4,1,4
0107,vap_asian,1,2,1,2
0107,vap_black,1095,1052,-43,1069
0107,vap_hisp,28,16,-12,21
0107,vap_nhpi,0,0,0,0
0107,vap_other,1,7,6,5
0107,vap_two,10,28,18,21
0107,vap_white,24,32,8,29
0108,pop,1561,1422,-139,1478
0108,pop_aian,1,0,-1,0
0108,pop_asian,5,3,-2,4
0108,pop_black,1462,1336,-126,1386
0108,pop_hisp,21,30,9,26
0108,pop_nhpi,0,0,0,0
0108,pop_other,5,1,-4,3
0108,pop_two,35,45,10,41
0108,pop_white,32,7,-25,17
0108,vap,1105,1054,-51,1074
0108,vap_aian,1,0,-1,0
0108,vap_asian,4,2,-2,3
0108,vap_black,1045,995,-50,1015
0108,vap_hisp,14,22,8,19
0108,vap_nhpi,0,0,0,0
0108,vap_other,0,1,1,1
0108,vap_two,15,27,12,22
0108,vap_white,26,7,-19,15
0109,pop,2154,1704,-450,1884
0109,pop_aian,3,10,7,7
0109,pop_asian,5,14,9,10
0109,pop_black,2076,1563,-513,1768
0109,pop_hisp,30,37,7,34
0109,pop_nhpi,1,0,-1,0
0109,pop_other,1,7,6,5
0109,pop_two,22,43,21,35
0109,pop_white,16,30,14,24
0109,vap,1438,1141,-297,1260
0109,vap_aian,3,10,7,7
0109,vap_asian,3,10,7,7
0109,vap_black,1385,1051,-334,1185
0109,vap_hisp,15,23,8,20
0109,vap_nhpi,1,0,-1,0
0109,vap_other,0,7,7,4
0109,vap_two,16,18,2,17
0109,vap_white,15,22,7,19
0110,pop,1381,1060,-321,1188
0110,pop_aian,9,1,-8,4
0110,pop_asian,8,7,-1,7
0110,pop_black,1298,961,-337,1096
0110,pop_hisp,33,40,7,37
0110,pop_nhpi,0,0,0,0
0110,pop_other,0,8,8,5
0110,pop_two,20,29,9,25
0110,pop_white,13,14,1,14
0110,vap,877,690,-187,765
0110,vap_aian,4,1,-3,2
0110,vap_asian,5,7,2,6
0110,vap_black,826,619,-207,702
0110,vap_hisp,21,32,11,28
0110,vap_nhpi,0,0,0,0
0110,vap_other,0,4,4,2
0110,vap_two,8,16,8,13
0110,vap_white,13,11,-2,12
0111,pop,1988,1477,-511,1681
0111,pop_aian,6,4,-2,5
0111,pop_asian,12,4,-8,7
0111,pop_black,1882,1315,-567,1542
0111,pop_hisp,20,87,67,60
0111,pop_nhpi,0,0,0,0
0111,pop_other,3,21,18,14
0111,pop_two,38,24,-14,30
0111,pop_white,27,22,-5,24
0111,vap,1251,1006,-245,1104
0111,vap_aian,4,2,-2,3
0111,vap_asian,10,4,-6,6
0111,vap_black,1183,896,-287,1011
0111,vap_hisp,11,56,45,38
0111,vap_nhpi,0,0,0,0
0111,vap_other,2,12,10,8
0111,vap_two,15,17,2,16
0111,vap_white,26,19,-7,22
0112,pop,1937,1448,-489,1644
0112,pop_aian,5,3,-2,4
0112,pop_asian,1,3,2,2
0112,pop_black,1836,1345,-491,1541
0112,pop_hisp,44,36,-8,39
0112,pop_nhpi,0,0,0,0
0112,pop_other,6,4,-2,5
0112,pop_two,36,37,1,37
0112,pop_white,9,20,11,16
0112,vap,1261,1004,-257,1107
0112,vap_aian,5,2,-3,3
0112,vap_asian,0,3,3,2
0112,vap_black,1206,930,-276,1040
0112,vap_hisp,19,23,4,21
0112,vap_nhpi,0,0,0,0
0112,vap_other,2,4,2,3
0112,vap_two,21,22,1,22
0112,vap_white,8,20,12,15
0113,pop,1767,1369,-398,1528
0113,pop_aian,1,7,6,5
0113,pop_asian,4,7,3,6
0113,pop_black,1681,1274,-407,1437
0113,pop_hisp,29,39,10,35
0113,pop_nhpi,1,0,-1,0
0113,pop_other,0,7,7,4
0113,pop_two,35,25,-10,29
0113,pop_white,16,10,-6,12
0113,vap,1199,974,-225,1064
0113,vap_aian,1,4,3,3
0113,vap_asian,4,7,3,6
0113,vap_black,1139,910,-229,1002
0113,vap_hisp,17,34,17,27
0113,vap_nhpi,1,0,-1,0
0113,vap_other,0,1,1,1
0113,vap_two,24,10,-14,16
0113,vap_white,13,8,-5,10
0114,pop,1223,1122,-101,1162
0114,pop_aian,17,0,-17,7
0114,pop_asian,6,3,-3,4
0114,pop_black,1139,1050,-89,1086
0114,pop_hisp,28,26,-2,27
0114,pop_nhpi,0,0,0,0
0114,pop_other,1,0,-1,0
0114,pop_two,20,26,6,24
0114,pop_white,12,17,5,15
0114,vap,875,802,-73,831
0114,vap_aian,8,0,-8,3
0114,vap_asian,4,1,-3,2
0114,vap_black,824,763,-61,787
0114,vap_hisp,14,11,-3,12
0114,vap_nhpi,0,0,0,0
0114,vap_other,1,0,-1,0
0114,vap_two,12,13,1,13
0114,vap_white,12,14,2,13
0115,pop,2188,2032,-156,2094
0115,pop_aian,1,7,6,5
0115,pop_asian,24,12,-12,17
0115,pop_black,2044,1869,-175,1939
0115,pop_hisp,49,45,-4,47
0115,pop_nhpi,0,2,2,1
0115,pop_other,2,9,7,6
0115,pop_two,49,53,4,51
0115,pop_white,19,35,16,29
0115,vap,1542,1412,-130,1464
0115,vap_aian,0,1,1,1
0115,vap_asian,13,9,-4,11
0115,vap_black,1459,1316,-143,1373
0115,vap_hisp,26,22,-4,24
0115,vap_nhpi,0,2,2,1
0115,vap_other,2,8,6,6
0115,vap_two,23,26,3,25
0115,vap_white,19,28,9,24
0116,pop,1552,1243,-309,1367
0116,pop_aian,4,1,-3,2
0116,pop_asian,0,0,0,0
0116,pop_black,1473,1115,-358,1258
0116,pop_hisp,51,56,5,54
0116,pop_nhpi,0,0,0,0
0116,pop_other,0,1,1,1
0116,pop_two,11,46,35,32
0116,pop_white,13,24,11,20
0116,vap,1015,831,-184,905
0116,vap_aian,2,0,-2,1
0116,vap_asian,0,0,0,0
0116,vap_black,966,737,-229,829
0116,vap_hisp,26,35,9,31
0116,vap_nhpi,0,0,0,0
0116,vap_other,0,1,1,1
0116,vap_two,9,34,25,24
0116,vap_white,12,24,12,19
0117,pop,1594,1215,-379,1367
0117,pop_aian,0,6,6,4
0117,pop_asian,0,0,0,0
0117,pop_black,1520,1110,-410,1274
0117,pop_hisp,37,39,2,38
0117,pop_nhpi,0,0,0,0
0117,pop_other,0,0,0,0
0117,pop_two,9,33,24,23
0117,pop_white,28,27,-1,27
0117,vap,1030,794,-236,888
0117,vap_aian,0,5,5,3
0117,vap_asian,0,0,0,0
0117,vap_black,984,718,-266,824
0117,vap_hisp,17,29,12,24
0117,vap_nhpi,0,0,0,0
0117,vap_other,0,0,0,0
0117,vap_two,5,20,15,14
0117,vap_white,24,22,-2,23
0118,pop,1566,1352,-214,1438
0118,pop_aian,2,0,-2,1
0118,pop_asian,18,8,-10,12
0118,pop_black,1420,1178,-242,1275
0118,pop_hisp,64,80,16,74
0118,pop_nhpi,0,0,0,0
0118,pop_other,1,2,1,2
0118,pop_two,9,42,33,29
0118,pop_white,52,42,-10,46
0118,vap,1104,938,-166,1004
0118,vap_aian,2,0,-2,1
0118,vap_asian,13,8,-5,10
0118,vap_black,1005,813,-192,890
0118,vap_hisp,28,55,27,44
0118,vap_nhpi,0,0,0,0
0118,vap_other,0,1,1,1
0118,vap_two,7,25,18,18
0118,vap_white,49,36,-13,41
0119,pop,1810,1512,-298,1631
0119,pop_aian,6,3,-3,4
0119,pop_asian,2,14,12,9
0119,pop_black,1675,1325,-350,1465
0119,pop_hisp,75,85,10,81
0119,pop_nhpi,0,0,0,0
0119,pop_other,10,2,-8,5
0119,pop_two,9,37,28,26
0119,pop_white,33,46,13,41
0119,vap,1218,1046,-172,1115
0119,vap_aian,4,3,-1,3
0119,vap_asian,2,9,7,6
0119,vap_black,1123,929,-194,1007
0119,vap_hisp,48,46,-2,47
0119,vap_nhpi,0,0,0,0
0119,vap_other,3,2,-1,2
0119,vap_two,6,23,17,16
0119,vap_white,32,34,2,33
0120,pop,1845,1521,-324,1651
0120,pop_aian,10,9,-1,9
0120,pop_asian,7,2,-5,4
0120,pop_black,1579,1197,-382,1350
0120,pop_hisp,112,171,59,147
0120,pop_nhpi,0,0,0,0
0120,pop_other,5,11,6,9
0120,pop_two,31,42,11,38
0120,pop_white,101,89,-12,94
0120,vap,1170,1032,-138,1087
0120,vap_aian,7,6,-1,6
0120,vap_asian,4,2,-2,3
0120,vap_black,980,788,-192,865
0120,vap_hisp,66,114,48,95
0120,vap_nhpi,0,0,0,0
0120,vap_other,3,9,6,7
0120,vap_two,14,25,11,21
0120,vap_white,96,88,-8,91
0121,pop,1841,1627,-214,1713
0121,pop_aian,3,10,7,7
0121,pop_asian,3,3,0,3
0121,pop_black,1706,1394,-312,1519
0121,pop_hisp,64,84,20,76
0121,pop_nhpi,0,0,0,0
0121,pop_other,2,10,8,7
0121,pop_two,47,57,10,53
0121,pop_white,16,69,53,48
0121,vap,1191,1112,-79,1144
0121,vap_aian,3,8,5,6
0121,vap_asian,3,2,-1,2
0121,vap_black,1119,955,-164,1021
0121,vap_hisp,34,46,12,41
0121,vap_nhpi,0,0,0,0
0121,vap_other,0,8,8,5
0121,vap_two,20,40,20,32
0121,vap_white,12,53,41,37
0122,pop,2071,1860,-211,1944
0122,pop_aian,4,3,-1,3
0122,pop_asian,1,6,5,4
0122,pop_black,1774,1372,-402,1533
0122,pop_hisp,143,207,64,181
0122,pop_nhpi,1,0,-1,0
0122,pop_other,3,2,-1,2
0122,pop_two,60,100,40,84
0122,pop_white,85,170,85,136
0122,vap,1334,1236,-98,1275
0122,vap_aian,4,0,-4,2
0122,vap_asian,1,6,5,4
0122,vap_black,1133,914,-219,1002
0122,vap_hisp,83,133,50,113
0122,vap_nhpi,1,0,-1,0
0122,vap_other,3,1,-2,2
0122,vap_two,29,47,18,40
0122,vap_white,80,135,55,113
0123,pop,2332,2045,-287,2160
0123,pop_aian,24,20,-4,22
0123,pop_asian,6,11,5,9
0123,pop_black,1222,957,-265,1063
0123,pop_hisp,436,358,-78,389
0123,pop_nhpi,0,0,0,0
0123,pop_other,11,6,-5,8
0123,pop_two,88,89,1,89
0123,pop_white,545,604,59,580
0123,vap,1588,1496,-92,1533
0123,vap_aian,22,17,-5,19
0123,vap_asian,5,7,2,6
0123,vap_black,748,635,-113,680
0123,vap_hisp,279,232,-47,251
0123,vap_nhpi,0,0,0,0
0123,vap_other,8,6,-2,7
0123,vap_two,42,62,20,54
0123,vap_white,484,537,53,516
0124,pop,1523,1170,-353,1311
0124,pop_aian,4,1,-3,2
0124,pop_asian,92,63,-29,75
0124,pop_black,672,514,-158,577
0124,pop_hisp,72,99,27,88
0124,pop_nhpi,0,0,0,0
0124,pop_other,4,4,0,4
0124,pop_two,32,60,28,49
0124,pop_white,647,429,-218,516
0124,vap,1365,1025,-340,1161
0124,vap_aian,2,0,-2,1
0124,vap_asian,77,61,-16,67
0124,vap_black,583,435,-148,494
0124,vap_hisp,54,68,14,62
0124,vap_nhpi,0,0,0,0
0124,vap_other,2,4,2,3
0124,vap_two,20,36,16,30
0124,vap_white,627,421,-206,503
0125,pop,1825,1766,-59,1790
0125,pop_aian,21,6,-15,12
0125,pop_asian,14,32,18,25
0125,pop_black,157,151,-6,153
0125,pop_hisp,216,223,7,220
0125,pop_nhpi,0,0,0,0
0125,pop_other,1,11,10,7
0125,pop_two,80,107,27,96
0125,pop_white,1336,1236,-100,1276
0125,vap,1537,1525,-12,1530
0125,vap_aian,16,4,-12,9
0125,vap_asian,14,27,13,22
0125,vap_black,112,114,2,113
0125,vap_hisp,155,158,3,157
0125,vap_nhpi,0,0,0,0
0125,vap_other,1,10,9,6
0125,vap_two,39,74,35,60
0125,vap_white,1200,1138,-62,1163
0126,pop,1245,1220,-25,1230
0126,pop_aian,1,0,-1,0
0126,pop_asian,14,13,-1,13
0126,pop_black,327,318,-9,322
0126,pop_hisp,83,76,-7,79
0126,pop_nhpi,0,0,0,0
0126,pop_other,0,5,5,3
0126,pop_two,40,76,36,62
0126,pop_white,780,732,-48,751
0126,vap,1094,1109,15,1103
0126,vap_aian,1,0,-1,0
0126,vap_asian,12,13,1,13
0126,vap_black,285,278,-7,281
0126,vap_hisp,56,64,8,61
0126,vap_nhpi,0,0,0,0
0126,vap_other,0,2,2,1
0126,vap_two,22,62,40,46
0126,vap_white,718,690,-28,701
0127,pop,2400,2859,459,2675
0127,pop_aian,12,4,-8,7
0127,pop_asian,113,123,10,119
0127,pop_black,53,104,51,84
0127,pop_hisp,84,202,118,155
0127,pop_nhpi,1,1,0,1
0127,pop_other,4,79,75,49
0127,pop_two,35,96,61,72
0127,pop_white,2098,2250,152,2189
0127,vap,2273,2657,384,2503
0127,vap_aian,10,3,-7,6
0127,vap_asian,110,112,2,111
0127,vap_black,47,84,37,69
0127,vap_hisp,65,166,101,126
0127,vap_nhpi,1,0,-1,0
0127,vap_other,3,77,74,47
0127,vap_two,26,78,52,57
0127,vap_white,2011,2137,126,2087
0128,pop,2886,2862,-24,2872
0128,pop_aian,5,13,8,10
0128,pop_asian,69,109,40,93
0128,pop_black,55,137,82,104
0128,pop_hisp,88,185,97,146
0128,pop_nhpi,1,0,-1,0
0128,pop_other,5,33,28,22
0128,pop_two,49,127,78,96
0128,pop_white,2614,2258,-356,2400
0128,vap,2759,2664,-95,2702
0128,vap_aian,5,13,8,10
0128,vap_asian,62,109,47,90
0128,vap_black,51,107,56,85
0128,vap_hisp,83,172,89,136
0128,vap_nhpi,1,0,-1,0
0128,vap_other,1,18,17,11
0128,vap_two,42,104,62,79
0128,vap_white,2514,2141,-373,2290
0129,pop,1780,1725,-55,1747
0129,pop_aian,1,1,0,1
0129,pop_asian,46,88,42,71
0129,pop_black,38,67,29,55
0129,pop_hisp,45,91,46,73
0129,pop_nhpi,0,0,0,0
0129,pop_other,15,16,1,16
0129,pop_two,31,53,22,44
0129,pop_white,1604,1409,-195,1487
0129,vap,1580,1488,-92,1525
0129,vap_aian,1,1,0,1
0129,vap_asian,39,81,42,64
0129,vap_black,28,65,37,50
0129,vap_hisp,38,66,28,55
0129,vap_nhpi,0,0,0,0
0129,vap_other,3,7,4,5
0129,vap_two,23,40,17,33
0129,vap_white,1448,1228,-220,1316
0130,pop,2765,2188,-577,2419
0130,pop_aian,8,0,-8,3
0130,pop_asian,59,35,-24,45
0130,pop_black,99,16,-83,49
0130,pop_hisp,96,126,30,114
0130,pop_nhpi,1,0,-1,0
0130,pop_other,22,219,197,140
0130,pop_two,43,26,-17,33
0130,pop_white,2437,1766,-671,2034
0130,vap,2744,2159,-585,2393
0130,vap_aian,8,0,-8,3
0130,vap_asian,57,31,-26,41
0130,vap_black,98,9,-89,45
0130,vap_hisp,95,125,30,113
0130,vap_nhpi,1,0,-1,0
0130,vap_other,22,219,197,140
0130,vap_two,43,19,-24,29
0130,vap_white,2420,1756,-664,2022
0131,pop,1735,1731,-4,1733
0131,pop_aian,2,3,1,3
0131,pop_asian,25,63,38,48
0131,pop_black,37,47,10,43
0131,pop_hisp,83,87,4,85
0131,pop_nhpi,0,0,0,0
0131,pop_other,1,16,15,10
0131,pop_two,20,73,53,52
0131,pop_white,1567,1442,-125,1492
0131,vap,1431,1406,-25,1416
0131,vap_aian,2,3,1,3
0131,vap_asian,24,53,29,41
0131,vap_black,29,41,12,36
0131,vap_hisp,61,68,7,65
0131,vap_nhpi,0,0,0,0
0131,vap_other,1,15,14,9
0131,vap_two,13,40,27,29
0131,vap_white,1301,1186,-115,1232
0132,pop,2242,2352,110,2308
0132,pop_aian,1,9,8,6
0132,pop_asian,44,31,-13,36
0132,pop_black,48,104,56,82
0132,pop_hisp,38,102,64,76
0132,pop_nhpi,0,0,0,0
0132,pop_other,1,22,21,14
0132,pop_two,35,84,49,64
0132,pop_white,2075,2000,-75,2030
0132,vap,2004,2055,51,2035
0132,vap_aian,1,9,8,6
0132,vap_asian,37,22,-15,28
0132,vap_black,40,103,63,78
0132,vap_hisp,28,73,45,55
0132,vap_nhpi,0,0,0,0
0132,vap_other,1,17,16,11
0132,vap_two,18,55,37,40
0132,vap_white,1879,1776,-103,1817
0133,pop,1463,1404,-59,1428
0133,pop_aian,2,4,2,3
0133,pop_asian,39,54,15,48
0133,pop_black,46,75,29,63
0133,pop_hisp,35,104,69,76
0133,pop_nhpi,1,2,1,2
0133,pop_other,0,6,6,4
0133,pop_two,18,57,39,41
0133,pop_white,1321,1102,-219,1190
0133,vap,1432,1323,-109,1367
0133,vap_aian,1,4,3,3
0133,vap_asian,36,53,17,46
0133,vap_black,46,73,27,62
0133,vap_hisp,33,96,63,71
0133,vap_nhpi,1,2,1,2
0133,vap_other,0,1,1,1
0133,vap_two,16,47,31,35
0133,vap_white,1298,1047,-251,1147
0134,pop,1746,1717,-29,1729
0134,pop_aian,4,1,-3,2
0134,pop_asian,139,131,-8,134
0134,pop_black,73,130,57,107
0134,pop_hisp,53,159,106,117
0134,pop_nhpi,3,0,-3,1
0134,pop_other,1,12,11,8
0134,pop_two,39,70,31,58
0134,pop_white,1434,1214,-220,1302
0134,vap,1682,1642,-40,1658
0134,vap_aian,4,0,-4,2
0134,vap_asian,133,126,-7,129
0134,vap_black,65,113,48,94
0134,vap_hisp,49,149,100,109
0134,vap_nhpi,3,0,-3,1
0134,vap_other,1,11,10,7
0134,vap_two,27,57,30,45
0134,vap_white,1400,1186,-214,1272
0135,pop,1655,2105,450,1925
0135,pop_aian,9,7,-2,8
0135,pop_asian,95,219,124,169
0135,pop_black,94,207,113,162
0135,pop_hisp,74,143,69,115
0135,pop_nhpi,1,3,2,2
0135,pop_other,6,12,6,10
0135,pop_two,30,91,61,67
0135,pop_white,1347,1423,76,1393
0135,vap,1597,1995,398,1836
0135,vap_aian,7,6,-1,6
0135,vap_asian,90,204,114,158
0135,vap_black,88,182,94,144
0135,vap_hisp,70,138,68,111
0135,vap_nhpi,1,3,2,2
0135,vap_other,5,11,6,9
0135,vap_two,26,82,56,60
0135,vap_white,1311,1369,58,1346
0136,pop,1507,1561,54,1539
0136,pop_aian,1,4,3,3
0136,pop_asian,55,60,5,58
0136,pop_black,62,94,32,81
0136,pop_hisp,55,119,64,93
0136,pop_nhpi,0,3,3,2
0136,pop_other,3,4,1,4
0136,pop_two,46,72,26,62
0136,pop_white,1285,1205,-80,1237
0136,vap,1450,1444,-6,1446
0136,vap_aian,1,3,2,2
0136,vap_asian,54,58,4,56
0136,vap_black,57,85,28,74
0136,vap_hisp,49,110,61,86
0136,vap_nhpi,0,3,3,2
0136,vap_other,3,1,-2,2
0136,vap_two,33,49,16,43
0136,vap_white,1253,1135,-118,1182
0137,pop,1246,1383,137,1328
0137,pop_aian,5,5,0,5
0137,pop_asian,33,24,-9,28
0137,pop_black,95,81,-14,87
0137,pop_hisp,75,88,13,83
0137,pop_nhpi,0,0,0,0
0137,pop_other,11,57,46,39
0137,pop_two,31,46,15,40
0137,pop_white,996,1082,86,1048
0137,vap,1158,1314,156,1252
0137,vap_aian,4,5,1,5
0137,vap_asian,33,24,-9,28
0137,vap_black,85,72,-13,77
0137,vap_hisp,61,78,17,71
0137,vap_nhpi,0,0,0,0
0137,vap_other,8,57,49,37
0137,vap_two,22,30,8,27
0137,vap_white,945,1048,103,1007
0138,pop,3233,3059,-174,3129
0138,pop_aian,21,9,-12,14
0138,pop_asian,35,32,-3,33
0138,pop_black,396,287,-109,331
0138,pop_hisp,347,295,-52,316
0138,pop_nhpi,1,1,0,1
0138,pop_other,9,21,12,16
0138,pop_two,114,164,50,144
0138,pop_white,2310,2250,-60,2274
0138,vap,2854,2710,-144,2768
0138,vap_aian,18,7,-11,11
0138,vap_asian,33,29,-4,31
0138,vap_black,290,220,-70,248
0138,vap_hisp,256,237,-19,245
0138,vap_nhpi,1,1,0,1
0138,vap_other,6,18,12,13
0138,vap_two,80,126,46,108
0138,vap_white,2170,2072,-98,2111
0139,pop,2946,2482,-464,2668
0139,pop_aian,12,11,-1,11
0139,pop_asian,18,30,12,25
0139,pop_black,1240,795,-445,973
0139,pop_hisp,616,486,-130,538
0139,pop_nhpi,0,1,1,1
0139,pop_other,4,15,11,11
0139,pop_two,114,132,18,125
0139,pop_white,942,1012,70,984
0139,vap,2139,1981,-158,2044
0139,vap_aian,11,10,-1,10
0139,vap_asian,15,21,6,19
0139,vap_black,798,581,-217,668
0139,vap_hisp,402,351,-51,371
0139,vap_nhpi,0,1,1,1
0139,vap_other,2,12,10,8
0139,vap_two,58,89,31,77
0139,vap_white,853,916,63,891
0140,pop,1088,965,-123,1014
0140,pop_aian,7,0,-7,3
0140,pop_asian,1,1,0,1
0140,pop_black,812,657,-155,719
0140,pop_hisp,145,144,-1,144
0140,pop_nhpi,0,0,0,0
0140,pop_other,0,7,7,4
0140,pop_two,45,30,-15,36
0140,pop_white,78,126,48,107
0140,vap,719,688,-31,700
0140,vap_aian,4,0,-4,2
0140,vap_asian,1,1,0,1
0140,vap_black,528,451,-77,482
0140,vap_hisp,98,104,6,102
0140,vap_nhpi,0,0,0,0
0140,vap_other,0,4,4,2
0140,vap_two,18,19,1,19
0140,vap_white,70,109,39,93
0141,pop,1471,1301,-170,1369
0141,pop_aian,5,0,-5,2
0141,pop_asian,2,12,10,8
0141,pop_black,1279,1012,-267,1119
0141,pop_hisp,59,79,20,71
0141,pop_nhpi,1,1,0,1
0141,pop_other,1,13,12,8
0141,pop_two,45,62,17,55
0141,pop_white,79,122,43,105
0141,vap,957,942,-15,948
0141,vap_aian,3,0,-3,1
0141,vap_asian,2,5,3,4
0141,vap_black,828,751,-77,782
0141,vap_hisp,32,43,11,39
0141,vap_nhpi,1,1,0,1
0141,vap_other,1,5,4,3
0141,vap_two,22,36,14,30
0141,vap_white,68,101,33,88
0142,pop,1436,1361,-75,1391
0142,pop_aian,13,5,-8,8
0142,pop_asian,10,5,-5,7
0142,pop_black,1284,1075,-209,1159
0142,pop_hisp,51,82,31,70
0142,pop_nhpi,0,0,0,0
0142,pop_other,0,10,10,6
0142,pop_two,41,85,44,67
0142,pop_white,37,99,62,74
0142,vap,979,1001,22,992
0142,vap_aian,8,5,-3,6
0142,vap_asian,9,0,-9,4
0142,vap_black,878,799,-79,831
0142,vap_hisp,31,47,16,41
0142,vap_nhpi,0,0,0,0
0142,vap_other,0,4,4,2
0142,vap_two,19,54,35,40
0142,vap_white,34,92,58,69
0143,pop,1777,1254,-523,1463
0143,pop_aian,3,4,1,4
0143,pop_asian,22,9,-13,14
0143,pop_black,1640,1078,-562,1303
0143,pop_hisp,46,57,11,53
0143,pop_nhpi,0,0,0,0
0143,pop_other,1,12,11,8
0143,pop_two,45,52,7,49
0143,pop_white,20,42,22,33
0143,vap,1063,844,-219,932
0143,vap_aian,3,4,1,4
0143,vap_asian,13,4,-9,8
0143,vap_black,984,732,-252,833
0143,vap_hisp,25,24,-1,24
0143,vap_nhpi,0,0,0,0
0143,vap_other,1,12,11,8
0143,vap_two,20,36,16,30
0143,vap_white,17,32,15,26
0144,pop,1104,889,-215,975
0144,pop_aian,5,4,-1,4
0144,pop_asian,1,8,7,5
0144,pop_black,1028,798,-230,890
0144,pop_hisp,27,29,2,28
0144,pop_nhpi,0,0,0,0
0144,pop_other,0,7,7,4
0144,pop_two,23,17,-6,19
0144,pop_white,20,26,6,24
0144,vap,704,647,-57,670
0144,vap_aian,3,3,0,3
0144,vap_asian,1,7,6,5
0144,vap_black,657,586,-71,614
0144,vap_hisp,17,19,2,18
0144,vap_nhpi,0,0,0,0
0144,vap_other,0,2,2,1
0144,vap_two,11,9,-2,10
0144,vap_white,15,21,6,19
0145,pop,743,742,-1,742
0145,pop_aian,2,1,-1,1
0145,pop_asian,10,1,-9,5
0145,pop_black,701,622,-79,654
0145,pop_hisp,14,27,13,22
0145,pop_nhpi,0,0,0,0
0145,pop_other,0,1,1,1
0145,pop_two,5,34,29,22
0145,pop_white,11,56,45,38
0145,vap,485,488,3,487
0145,vap_aian,2,1,-1,1
0145,vap_asian,7,1,-6,3
0145,vap_black,454,415,-39,431
0145,vap_hisp,7,12,5,10
0145,vap_nhpi,0,0,0,0
0145,vap_other,0,1,1,1
0145,vap_two,4,14,10,10
0145,vap_white,11,44,33,31
0146,pop,717,493,-224,583
0146,pop_aian,3,0,-3,1
0146,pop_asian,0,1,1,1
0146,pop_black,681,447,-234,541
0146,pop_hisp,15,23,8,20
0146,pop_nhpi,0,0,0,0
0146,pop_other,0,1,1,1
0146,pop_two,16,15,-1,15
0146,pop_white,2,6,4,4
0146,vap,453,367,-86,401
0146,vap_aian,3,0,-3,1
0146,vap_asian,0,1,1,1
0146,vap_black,431,334,-97,373
0146,vap_hisp,8,13,5,11
0146,vap_nhpi,0,0,0,0
0146,vap_other,0,1,1,1
0146,vap_two,9,12,3,11
0146,vap_white,2,6,4,4
0147,pop,2646,2252,-394,2410
0147,pop_aian,5,4,-1,4
0147,pop_asian,6,10,4,8
0147,pop_black,2516,2020,-496,2218
0147,pop_hisp,53,64,11,60
0147,pop_nhpi,0,0,0,0
0147,pop_other,5,7,2,6
0147,pop_two,32,78,46,60
0147,pop_white,29,69,40,53
0147,vap,1606,1449,-157,1512
0147,vap_aian,4,4,0,4
0147,vap_asian,3,5,2,4
0147,vap_black,1536,1308,-228,1399
0147,vap_hisp,23,24,1,24
0147,vap_nhpi,0,0,0,0
0147,vap_other,1,3,2,2
0147,vap_two,21,43,22,34
0147,vap_white,18,62,44,44
0148,pop,1664,1532,-132,1585
0148,pop_aian,2,3,1,3
0148,pop_asian,8,9,1,9
0148,pop_black,1536,1379,-157,1442
0148,pop_hisp,70,72,2,71
0148,pop_nhpi,0,0,0,0
0148,pop_other,2,4,2,3
0148,pop_two,23,38,15,32
0148,pop_white,23,27,4,25
0148,vap,1063,1032,-31,1044
0148,vap_aian,2,3,1,3
0148,vap_asian,8,8,0,8
0148,vap_black,988,922,-66,948
0148,vap_hisp,34,50,16,44
0148,vap_nhpi,0,0,0,0
0148,vap_other,2,4,2,3
0148,vap_two,8,27,19,19
0148,vap_white,21,18,-3,19
0149,pop,2403,1825,-578,2056
0149,pop_aian,5,0,-5,2
0149,pop_asian,28,70,42,53
0149,pop_black,2192,1550,-642,1807
0149,pop_hisp,70,103,33,90
0149,pop_nhpi,0,2,2,1
0149,pop_other,0,5,5,3
0149,pop_two,61,55,-6,57
0149,pop_white,47,40,-7,43
0149,vap,1505,1250,-255,1352
0149,vap_aian,5,0,-5,2
0149,vap_asian,17,35,18,28
0149,vap_black,1377,1071,-306,1193
0149,vap_hisp,36,70,34,56
0149,vap_nhpi,0,2,2,1
0149,vap_other,0,5,5,3
0149,vap_two,34,34,0,34
0149,vap_white,36,33,-3,34
0150,pop,1784,1862,78,1831
0150,pop_aian,9,6,-3,7
0150,pop_asian,265,440,175,370
0150,pop_black,1333,1220,-113,1265
0150,pop_hisp,66,83,17,76
0150,pop_nhpi,0,0,0,0
0150,pop_other,0,11,11,7
0150,pop_two,38,68,30,56
0150,pop_white,73,34,-39,50
0150,vap,1090,1130,40,1114
0150,vap_aian,5,2,-3,3
0150,vap_asian,143,244,101,204
0150,vap_black,822,774,-48,793
0150,vap_hisp,40,40,0,40
0150,vap_nhpi,0,0,0,0
0150,vap_other,0,9,9,5
0150,vap_two,18,30,12,25
0150,vap_white,62,31,-31,43
0151,pop,1415,1137,-278,1248
0151,pop_aian,3,1,-2,2
0151,pop_asian,1,13,12,8
0151,pop_black,1309,990,-319,1118
0151,pop_hisp,34,51,17,44
0151,pop_nhpi,1,0,-1,0
0151,pop_other,0,4,4,2
0151,pop_two,10,32,22,23
0151,pop_white,57,46,-11,50
0151,vap,947,829,-118,876
0151,vap_aian,2,0,-2,1
0151,vap_asian,1,7,6,5
0151,vap_black,867,716,-151,776
0151,vap_hisp,15,34,19,26
0151,vap_nhpi,1,0,-1,0
0151,vap_other,0,4,4,2
0151,vap_two,7,24,17,17
0151,vap_white,54,44,-10,48
0152,pop,1433,1228,-205,1310
0152,pop_aian,2,0,-2,1
0152,pop_asian,27,36,9,32
0152,pop_black,1308,1018,-290,1134
0152,pop_hisp,63,116,53,95
0152,pop_nhpi,1,1,0,1
0152,pop_other,2,6,4,4
0152,pop_two,8,45,37,30
0152,pop_white,22,6,-16,12
0152,vap,870,793,-77,824
0152,vap_aian,2,0,-2,1
0152,vap_asian,11,24,13,19
0152,vap_black,794,657,-137,712
0152,vap_hisp,35,74,39,58
0152,vap_nhpi,1,1,0,1
0152,vap_other,2,6,4,4
0152,vap_two,6,27,21,19
0152,vap_white,19,4,-15,10
0153,pop,1824,1489,-335,1623
0153,pop_aian,12,4,-8,7
0153,pop_asian,19,7,-12,12
0153,pop_black,1644,1290,-354,1432
0153,pop_hisp,39,56,17,49
0153,pop_nhpi,0,0,0,0
0153,pop_other,0,13,13,8
0153,pop_two,21,63,42,46
0153,pop_white,89,56,-33,69
0153,vap,1158,1047,-111,1091
0153,vap_aian,6,3,-3,4
0153,vap_asian,9,1,-8,4
0153,vap_black,1022,912,-110,956
0153,vap_hisp,26,26,0,26
0153,vap_nhpi,0,0,0,0
0153,vap_other,0,9,9,5
0153,vap_two,12,44,32,31
0153,vap_white,83,52,-31,64
0154,pop,1711,1393,-318,1520
0154,pop_aian,3,1,-2,2
0154,pop_asian,10,24,14,18
0154,pop_black,1571,1224,-347,1363
0154,pop_hisp,46,51,5,49
0154,pop_nhpi,0,0,0,0
0154,pop_other,0,5,5,3
0154,pop_two,25,32,7,29
0154,pop_white,56,56,0,56
0154,vap,1040,930,-110,974
0154,vap_aian,3,1,-2,2
0154,vap_asian,7,14,7,11
0154,vap_black,938,818,-120,866
0154,vap_hisp,24,32,8,29
0154,vap_nhpi,0,0,0,0
0154,vap_other,0,4,4,2
0154,vap_two,15,16,1,16
0154,vap_white,53,45,-8,48
0155,pop,1880,1773,-107,1816
0155,pop_aian,3,7,4,5
0155,pop_asian,74,108,34,94
0155,pop_black,1686,1508,-178,1579
0155,pop_hisp,59,45,-14,51
0155,pop_nhpi,0,2,2,1
0155,pop_other,4,9,5,7
0155,pop_two,25,60,35,46
0155,pop_white,29,34,5,32
0155,vap,1046,1080,34,1066
0155,vap_aian,2,4,2,3
0155,vap_asian,31,69,38,54
0155,vap_black,941,900,-41,916
0155,vap_hisp,30,27,-3,28
0155,vap_nhpi,0,2,2,1
0155,vap_other,4,7,3,6
0155,vap_two,12,37,25,27
0155,vap_white,26,34,8,31
0156,pop,2078,2042,-36,2056
0156,pop_aian,4,7,3,6
0156,pop_asian,51,80,29,68
0156,pop_black,1821,1725,-96,1763
0156,pop_hisp,77,68,-9,72
0156,pop_nhpi,0,0,0,0
0156,pop_other,4,5,1,5
0156,pop_two,56,53,-3,54
0156,pop_white,65,104,39,88
0156,vap,1192,1263,71,1235
0156,vap_aian,2,5,3,4
0156,vap_asian,26,50,24,40
0156,vap_black,1049,1059,10,1055
0156,vap_hisp,36,38,2,37
0156,vap_nhpi,0,0,0,0
0156,vap_other,3,2,-1,2
0156,vap_two,22,31,9,27
0156,vap_white,54,78,24,68
0157,pop,1368,1167,-201,1247
0157,pop_aian,9,3,-6,5
0157,pop_asian,53,45,-8,48
0157,pop_black,972,708,-264,814
0157,pop_hisp,50,78,28,67
0157,pop_nhpi,0,0,0,0
0157,pop_other,0,5,5,3
0157,pop_two,48,71,23,62
0157,pop_white,236,257,21,249
0157,vap,864,777,-87,812
0157,vap_aian,6,1,-5,3
0157,vap_asian,31,34,3,33
0157,vap_black,593,452,-141,508
0157,vap_hisp,24,47,23,38
0157,vap_nhpi,0,0,0,0
0157,vap_other,0,1,1,1
0157,vap_two,14,27,13,22
0157,vap_white,196,215,19,207
0158,pop,1243,1117,-126,1167
0158,pop_aian,5,6,1,6
0158,pop_asian,58,24,-34,38
0158,pop_black,967,873,-94,911
0158,pop_hisp,51,75,24,65
0158,pop_nhpi,0,1,1,1
0158,pop_other,5,7,2,6
0158,pop_two,49,31,-18,38
0158,pop_white,108,100,-8,103
0158,vap,744,686,-58,709
0158,vap_aian,2,6,4,4
0158,vap_asian,33,9,-24,19
0158,vap_black,580,545,-35,559
0158,vap_hisp,27,31,4,29
0158,vap_nhpi,0,1,1,1
0158,vap_other,0,4,4,2
0158,vap_two,23,16,-7,19
0158,vap_white,79,74,-5,76
0159,pop,1203,1142,-61,1166
0159,pop_aian,8,2,-6,4
0159,pop_asian,15,24,9,20
0159,pop_black,1005,889,-116,935
0159,pop_hisp,53,56,3,55
0159,pop_nhpi,0,0,0,0
0159,pop_other,1,2,1,2
0159,pop_two,29,54,25,44
0159,pop_white,92,115,23,106
0159,vap,717,738,21,730
0159,vap_aian,4,2,-2,3
0159,vap_asian,11,24,13,19
0159,vap_black,586,564,-22,573
0159,vap_hisp,23,30,7,27
0159,vap_nhpi,0,0,0,0
0159,vap_other,1,2,1,2
0159,vap_two,13,23,10,19
0159,vap_white,79,93,14,87
0160,pop,1526,1513,-13,1518
0160,pop_aian,3,0,-3,1
0160,pop_asian,30,16,-14,22
0160,pop_black,1328,1277,-51,1297
0160,pop_hisp,35,91,56,69
0160,pop_nhpi,0,0,0,0
0160,pop_other,2,8,6,6
0160,pop_two,44,40,-4,42
0160,pop_white,84,81,-3,82
0160,vap,962,944,-18,951
0160,vap_aian,1,0,-1,0
0160,vap_asian,18,16,-2,17
0160,vap_black,832,817,-15,823
0160,vap_hisp,19,34,15,28
0160,vap_nhpi,0,0,0,0
0160,vap_other,2,5,3,4
0160,vap_two,14,16,2,15
0160,vap_white,76,56,-20,64
0161,pop,574,477,-97,516
0161,pop_aian,2,1,-1,1
0161,pop_asian,0,5,5,3
0161,pop_black,499,382,-117,429
0161,pop_hisp,26,30,4,28
0161,pop_nhpi,0,0,0,0
0161,pop_other,0,0,0,0
0161,pop_two,5,15,10,11
0161,pop_white,42,44,2,43
0161,vap,347,305,-42,322
0161,vap_aian,2,1,-1,1
0161,vap_asian,0,5,5,3
0161,vap_black,302,246,-56,268
0161,vap_hisp,11,15,4,13
0161,vap_nhpi,0,0,0,0
0161,vap_other,0,0,0,0
0161,vap_two,1,2,1,2
0161,vap_white,31,36,5,34
0162,pop,1049,1043,-6,1045
0162,pop_aian,0,7,7,4
0162,pop_asian,1,33,32,20
0162,pop_black,879,821,-58,844
0162,pop_hisp,49,58,9,54
0162,pop_nhpi,2,0,-2,1
0162,pop_other,4,1,-3,2
0162,pop_two,34,32,-2,33
0162,pop_white,80,91,11,87
0162,vap,695,683,-12,688
0162,vap_aian,0,0,0,0
0162,vap_asian,1,21,20,13
0162,vap_black,566,515,-51,535
0162,vap_hisp,37,43,6,41
0162,vap_nhpi,2,0,-2,1
0162,vap_other,1,1,0,1
0162,vap_two,12,22,10,18
0162,vap_white,76,81,5,79
0163,pop,1819,1511,-308,1634
0163,pop_aian,6,3,-3,4
0163,pop_asian,49,30,-19,38
0163,pop_black,1440,1171,-269,1279
0163,pop_hisp,72,92,20,84
0163,pop_nhpi,0,0,0,0
0163,pop_other,1,15,14,9
0163,pop_two,37,67,30,55
0163,pop_white,214,133,-81,165
0163,vap,1205,1028,-177,1099
0163,vap_aian,4,3,-1,3
0163,vap_asian,35,24,-11,28
0163,vap_black,908,792,-116,838
0163,vap_hisp,43,55,12,50
0163,vap_nhpi,0,0,0,0
0163,vap_other,1,7,6,5
0163,vap_two,18,26,8,23
0163,vap_white,196,121,-75,151
0164,pop,1775,1748,-27,1759
0164,pop_aian,11,4,-7,7
0164,pop_asian,55,34,-21,42
0164,pop_black,1012,1073,61,1049
0164,pop_hisp,100,128,28,117
0164,pop_nhpi,0,0,0,0
0164,pop_other,2,17,15,11
0164,pop_two,70,66,-4,68
0164,pop_white,525,426,-99,466
0164,vap,1292,1303,11,1299
0164,vap_aian,3,3,0,3
0164,vap_asian,35,29,-6,31
0164,vap_black,702,770,68,743
0164,vap_hisp,63,86,23,77
0164,vap_nhpi,0,0,0,0
0164,vap_other,1,10,9,6
0164,vap_two,33,37,4,35
0164,vap_white,455,368,-87,403
0165,pop,1852,1790,-62,1815
0165,pop_aian,15,8,-7,11
0165,pop_asian,57,100,43,83
0165,pop_black,944,894,-50,914
0165,pop_hisp,119,180,61,156
0165,pop_nhpi,0,0,0,0
0165,pop_other,2,6,4,4
0165,pop_two,61,113,52,92
0165,pop_white,654,489,-165,555
0165,vap,1296,1255,-41,1271
0165,vap_aian,10,6,-4,8
0165,vap_asian,36,75,39,59
0165,vap_black,577,582,5,580
0165,vap_hisp,80,101,21,93
0165,vap_nhpi,0,0,0,0
0165,vap_other,2,5,3,4
0165,vap_two,29,58,29,46
0165,vap_white,562,428,-134,482
0166,pop,704,634,-70,662
0166,pop_aian,3,1,-2,2
0166,pop_asian,12,13,1,13
0166,pop_black,348,259,-89,295
0166,pop_hisp,44,53,9,49
0166,pop_nhpi,0,0,0,0
0166,pop_other,1,4,3,3
0166,pop_two,25,28,3,27
0166,pop_white,271,276,5,274
0166,vap,501,497,-4,499
0166,vap_aian,3,1,-2,2
0166,vap_asian,11,11,0,11
0166,vap_black,212,193,-19,201
0166,vap_hisp,31,40,9,36
0166,vap_nhpi,0,0,0,0
0166,vap_other,0,0,0,0
0166,vap_two,8,15,7,12
0166,vap_white,236,237,1,237
0167,pop,1395,1282,-113,1327
0167,pop_aian,7,5,-2,6
0167,pop_asian,22,25,3,24
0167,pop_black,363,314,-49,334
0167,pop_hisp,78,94,16,88
0167,pop_nhpi,0,0,0,0
0167,pop_other,10,0,-10,4
0167,pop_two,46,78,32,65
0167,pop_white,869,766,-103,807
0167,vap,1042,1051,9,1047
0167,vap_aian,7,5,-2,6
0167,vap_asian,12,23,11,19
0167,vap_black,225,227,2,226
0167,vap_hisp,50,60,10,56
0167,vap_nhpi,0,0,0,0
0167,vap_other,5,0,-5,2
0167,vap_two,22,40,18,33
0167,vap_white,721,696,-25,706
0168,pop,2450,2360,-90,2396
0168,pop_aian,12,9,-3,10
0168,pop_asian,56,42,-14,48
0168,pop_black,363,327,-36,341
0168,pop_hisp,155,170,15,164
0168,pop_nhpi,0,0,0,0
0168,pop_other,0,11,11,7
0168,pop_two,86,114,28,103
0168,pop_white,1778,1687,-91,1723
0168,vap,1848,1841,-7,1844
0168,vap_aian,11,6,-5,8
0168,vap_asian,40,37,-3,38
0168,vap_black,225,220,-5,222
0168,vap_hisp,85,123,38,108
0168,vap_nhpi,0,0,0,0
0168,vap_other,0,8,8,5
0168,vap_two,30,52,22,43
0168,vap_white,1457,1395,-62,1420
0169,pop,1866,1686,-180,1758
0169,pop_aian,5,4,-1,4
0169,pop_asian,240,258,18,251
0169,pop_black,1387,1171,-216,1257
0169,pop_hisp,91,124,33,111
0169,pop_nhpi,0,1,1,1
0169,pop_other,0,7,7,4
0169,pop_two,52,57,5,55
0169,pop_white,91,64,-27,75
0169,vap,1025,1058,33,1045
0169,vap_aian,3,1,-2,2
0169,vap_asian,129,144,15,138
0169,vap_black,746,734,-12,739
0169,vap_hisp,52,86,34,72
0169,vap_nhpi,0,1,1,1
0169,vap_other,0,7,7,4
0169,vap_two,20,31,11,27
0169,vap_white,75,54,-21,62
0170,pop,1605,1511,-94,1549
0170,pop_aian,1,10,9,6
0170,pop_asian,708,617,-91,653
0170,pop_black,765,730,-35,744
0170,pop_hisp,24,66,42,49
0170,pop_nhpi,0,1,1,1
0170,pop_other,5,11,6,9
0170,pop_two,35,38,3,37
0170,pop_white,67,38,-29,50
0170,vap,898,922,24,912
0170,vap_aian,0,6,6,4
0170,vap_asian,361,376,15,370
0170,vap_black,440,459,19,451
0170,vap_hisp,15,30,15,24
0170,vap_nhpi,0,1,1,1
0170,vap_other,3,0,-3,1
0170,vap_two,18,12,-6,14
0170,vap_white,61,38,-23,47
0171,pop,1018,908,-110,952
0171,pop_aian,5,4,-1,4
0171,pop_asian,656,503,-153,564
0171,pop_black,277,300,23,291
0171,pop_hisp,44,60,16,54
0171,pop_nhpi,0,0,0,0
0171,pop_other,0,3,3,2
0171,pop_two,17,22,5,20
0171,pop_white,19,16,-3,17
0171,vap,559,559,0,559
0171,vap_aian,3,1,-2,2
0171,vap_asian,349,310,-39,326
0171,vap_black,155,192,37,177
0171,vap_hisp,28,36,8,33
0171,vap_nhpi,0,0,0,0
0171,vap_other,0,0,0,0
0171,vap_two,6,8,2,7
0171,vap_white,18,12,-6,14
0172,pop,1541,1308,-233,1401
0172,pop_aian,5,3,-2,4
0172,pop_asian,170,170,0,170
0172,pop_black,1087,911,-176,981
0172,pop_hisp,154,128,-26,138
0172,pop_nhpi,0,0,0,0
0172,pop_other,5,7,2,6
0172,pop_two,61,59,-2,60
0172,pop_white,59,30,-29,42
0172,vap,940,813,-127,864
0172,vap_aian,3,2,-1,2
0172,vap_asian,119,124,5,122
0172,vap_black,644,550,-94,588
0172,vap_hisp,91,76,-15,82
0172,vap_nhpi,0,0,0,0
0172,vap_other,1,1,0,1
0172,vap_two,24,34,10,30
0172,vap_white,58,26,-32,39
0173,pop,1606,1410,-196,1488
0173,pop_aian,2,3,1,3
0173,pop_asian,89,139,50,119
0173,pop_black,1322,1030,-292,1147
0173,pop_hisp,97,155,58,132
0173,pop_nhpi,0,0,0,0
0173,pop_other,3,8,5,6
0173,pop_two,45,53,8,50
0173,pop_white,48,22,-26,32
0173,vap,1082,933,-149,993
0173,vap_aian,1,3,2,2
0173,vap_asian,64,79,15,73
0173,vap_black,900,699,-201,779
0173,vap_hisp,63,100,37,85
0173,vap_nhpi,0,0,0,0
0173,vap_other,2,7,5,5
0173,vap_two,17,29,12,24
0173,vap_white,35,16,-19,24
0174,pop,2318,2063,-255,2165
0174,pop_aian,3,2,-1,2
0174,pop_asian,133,152,19,144
0174,pop_black,2009,1706,-303,1827
0174,pop_hisp,52,85,33,72
0174,pop_nhpi,0,0,0,0
0174,pop_other,4,14,10,10
0174,pop_two,55,59,4,57
0174,pop_white,62,45,-17,52
0174,vap,1486,1343,-143,1400
0174,vap_aian,0,2,2,1
0174,vap_asian,81,106,25,96
0174,vap_black,1296,1100,-196,1178
0174,vap_hisp,29,59,30,47
0174,vap_nhpi,0,0,0,0
0174,vap_other,1,7,6,5
0174,vap_two,24,34,10,30
0174,vap_white,55,35,-20,43
0175,pop,1002,1241,239,1145
0175,pop_aian,2,2,0,2
0175,pop_asian,11,10,-1,10
0175,pop_black,716,836,120,788
0175,pop_hisp,23,102,79,70
0175,pop_nhpi,0,1,1,1
0175,pop_other,1,12,11,8
0175,pop_two,10,53,43,36
0175,pop_white,239,225,-14,231
0175,vap,726,925,199,845
0175,vap_aian,2,2,0,2
0175,vap_asian,11,10,-1,10
0175,vap_black,472,595,123,546
0175,vap_hisp,18,67,49,47
0175,vap_nhpi,0,0,0,0
0175,vap_other,1,12,11,8
0175,vap_two,6,35,29,23
0175,vap_white,216,204,-12,209
0176,pop,1763,1938,175,1868
0176,pop_aian,7,5,-2,6
0176,pop_asian,7,16,9,12
0176,pop_black,1506,1629,123,1580
0176,pop_hisp,105,92,-13,97
0176,pop_nhpi,0,0,0,0
0176,pop_other,1,4,3,3
0176,pop_two,16,71,55,49
0176,pop_white,121,121,0,121
0176,vap,1187,1262,75,1232
0176,vap_aian,5,5,0,5
0176,vap_asian,6,16,10,12
0176,vap_black,993,1030,37,1015
0176,vap_hisp,61,57,-4,59
0176,vap_nhpi,0,0,0,0
0176,vap_other,1,4,3,3
0176,vap_two,10,44,34,30
0176,vap_white,111,106,-5,108
0177,pop,2840,3384,544,3166
0177,pop_aian,12,10,-2,11
0177,pop_asian,75,74,-1,74
0177,pop_black,697,623,-74,653
0177,pop_hisp,256,349,93,312
0177,pop_nhpi,0,1,1,1
0177,pop_other,5,3,-2,4
0177,pop_two,65,160,95,122
0177,pop_white,1730,2164,434,1990
0177,vap,2364,2958,594,2720
0177,vap_aian,9,6,-3,7
0177,vap_asian,66,68,2,67
0177,vap_black,475,450,-25,460
0177,vap_hisp,177,267,90,231
0177,vap_nhpi,0,0,0,0
0177,vap_other,2,3,1,3
0177,vap_two,33,110,77,79
0177,vap_white,1602,2054,452,1873
0178,pop,2350,2721,371,2573
0178,pop_aian,14,8,-6,10
0178,pop_asian,56,89,33,76
0178,pop_black,234,235,1,235
0178,pop_hisp,126,171,45,153
0178,pop_nhpi,0,2,2,1
0178,pop_other,8,4,-4,6
0178,pop_two,58,145,87,110
0178,pop_white,1854,2067,213,1982
0178,vap,2215,2599,384,2445
0178,vap_aian,13,8,-5,10
0178,vap_asian,54,82,28,71
0178,vap_black,217,220,3,219
0178,vap_hisp,107,154,47,135
0178,vap_nhpi,0,2,2,1
0178,vap_other,5,2,-3,3
0178,vap_two,40,132,92,95
0178,vap_white,1779,1999,220,1911
0179,pop,2522,2469,-53,2490
0179,pop_aian,8,1,-7,4
0179,pop_asian,64,90,26,80
0179,pop_black,321,341,20,333
0179,pop_hisp,116,162,46,144
0179,pop_nhpi,5,0,-5,2
0179,pop_other,6,18,12,13
0179,pop_two,52,94,42,77
0179,pop_white,1950,1763,-187,1838
0179,vap,2406,2376,-30,2388
0179,vap_aian,8,1,-7,4
0179,vap_asian,57,90,33,77
0179,vap_black,306,335,29,323
0179,vap_hisp,101,144,43,127
0179,vap_nhpi,5,0,-5,2
0179,vap_other,6,15,9,11
0179,vap_two,41,86,45,68
0179,vap_white,1882,1705,-177,1776
0180,pop,1619,2160,541,1944
0180,pop_aian,2,0,-2,1
0180,pop_asian,74,95,21,87
0180,pop_black,118,139,21,131
0180,pop_hisp,59,142,83,109
0180,pop_nhpi,0,0,0,0
0180,pop_other,2,40,38,25
0180,pop_two,27,65,38,50
0180,pop_white,1338,1679,341,1543
0180,vap,1559,2052,493,1855
0180,vap_aian,1,0,-1,0
0180,vap_asian,73,89,16,83
0180,vap_black,117,135,18,128
0180,vap_hisp,52,128,76,98
0180,vap_nhpi,0,0,0,0
0180,vap_other,2,34,32,21
0180,vap_two,19,58,39,42
0180,vap_white,1296,1608,312,1483
0181,pop,2172,2446,274,2336
0181,pop_aian,4,2,-2,3
0181,pop_asian,151,125,-26,135
0181,pop_black,104,112,8,109
0181,pop_hisp,66,92,26,82
0181,pop_nhpi,2,0,-2,1
0181,pop_other,1,14,13,9
0181,pop_two,24,66,42,49
0181,pop_white,1820,2035,215,1949
0181,vap,2129,2385,256,2283
0181,vap_aian,4,1,-3,2
0181,vap_asian,143,118,-25,128
0181,vap_black,97,109,12,104
0181,vap_hisp,61,74,13,69
0181,vap_nhpi,2,0,-2,1
0181,vap_other,1,14,13,9
0181,vap_two,21,58,37,43
0181,vap_white,1800,2011,211,1927
0182,pop,2488,2618,130,2566
0182,pop_aian,12,12,0,12
0182,pop_asian,105,136,31,124
0182,pop_black,201,219,18,212
0182,pop_hisp,105,174,69,146
0182,pop_nhpi,1,0,-1,0
0182,pop_other,0,14,14,8
0182,pop_two,40,109,69,81
0182,pop_white,2024,1954,-70,1982
0182,vap,2428,2560,132,2507
0182,vap_aian,12,12,0,12
0182,vap_asian,100,135,35,121
0182,vap_black,195,210,15,204
0182,vap_hisp,97,167,70,139
0182,vap_nhpi,1,0,-1,0
0182,vap_other,0,12,12,7
0182,vap_two,39,104,65,78
0182,vap_white,1984,1920,-64,1946
0183,pop,2785,4012,1227,3521
0183,pop_aian,16,0,-16,6
0183,pop_asian,121,167,46,149
0183,pop_black,165,263,98,224
0183,pop_hisp,146,294,148,235
0183,pop_nhpi,5,0,-5,2
0183,pop_other,2,8,6,6
0183,pop_two,50,147,97,108
0183,pop_white,2280,3133,853,2792
0183,vap,2656,3852,1196,3374
0183,vap_aian,14,0,-14,6
0183,vap_asian,112,165,53,144
0183,vap_black,146,248,102,207
0183,vap_hisp,126,256,130,204
0183,vap_nhpi,5,0,-5,2
0183,vap_other,2,5,3,4
0183,vap_two,42,127,85,93
0183,vap_white,2209,3051,842,2714
0184,pop,2646,2782,136,2728
0184,pop_aian,16,8,-8,11
0184,pop_asian,92,137,45,119
0184,pop_black,274,313,39,297
0184,pop_hisp,93,205,112,160
0184,pop_nhpi,0,0,0,0
0184,pop_other,1,45,44,27
0184,pop_two,45,91,46,73
0184,pop_white,2125,1983,-142,2040
0184,vap,2593,2736,143,2679
0184,vap_aian,15,8,-7,11
0184,vap_asian,87,133,46,115
0184,vap_black,265,303,38,288
0184,vap_hisp,90,194,104,152
0184,vap_nhpi,0,0,0,0
0184,vap_other,1,45,44,27
0184,vap_two,40,85,45,67
0184,vap_white,2095,1968,-127,2019
0185,pop,3810,4078,268,3971
0185,pop_aian,7,7,0,7
0185,pop_asian,377,428,51,408
0185,pop_black,119,159,40,143
0185,pop_hisp,156,233,77,202
0185,pop_nhpi,1,1,0,1
0185,pop_other,4,33,29,21
0185,pop_two,64,118,54,96
0185,pop_white,3082,3099,17,3092
0185,vap,3733,3981,248,3882
0185,vap_aian,7,3,-4,5
0185,vap_asian,355,397,42,380
0185,vap_black,112,158,46,140
0185,vap_hisp,143,220,77,189
0185,vap_nhpi,1,1,0,1
0185,vap_other,3,29,26,19
0185,vap_two,61,111,50,91
0185,vap_white,3051,3062,11,3058
0186,pop,2647,4014,1367,3467
0186,pop_aian,4,13,9,9
0186,pop_asian,99,187,88,152
0186,pop_black,154,198,44,180
0186,pop_hisp,90,244,154,182
0186,pop_nhpi,0,1,1,1
0186,pop_other,2,12,10,8
0186,pop_two,36,141,105,99
0186,pop_white,2263,3218,955,2836
0186,vap,2583,3877,1294,3359
0186,vap_aian,3,9,6,7
0186,vap_asian,97,180,83,147
0186,vap_black,137,182,45,164
0186,vap_hisp,85,218,133,165
0186,vap_nhpi,0,0,0,0
0186,vap_other,2,12,10,8
0186,vap_two,35,125,90,89
0186,vap_white,2224,3151,927,2780
0187,pop,1006,1655,649,1395
0187,pop_aian,6,7,1,7
0187,pop_asian,33,80,47,61
0187,pop_black,194,223,29,211
0187,pop_hisp,75,151,76,121
0187,pop_nhpi,0,2,2,1
0187,pop_other,1,7,6,5
0187,pop_two,14,83,69,55
0187,pop_white,683,1102,419,934
0187,vap,966,1562,596,1324
0187,vap_aian,6,6,0,6
0187,vap_asian,30,77,47,58
0187,vap_black,176,171,-5,173
0187,vap_hisp,68,139,71,111
0187,vap_nhpi,0,2,2,1
0187,vap_other,1,6,5,4
0187,vap_two,12,68,56,46
0187,vap_white,673,1093,420,925
0188,pop,2776,2083,-693,2360
0188,pop_aian,25,13,-12,18
0188,pop_asian,52,84,32,71
0188,pop_black,1324,722,-602,963
0188,pop_hisp,131,143,12,138
0188,pop_nhpi,5,0,-5,2
0188,pop_other,2,21,19,13
0188,pop_two,37,66,29,54
0188,pop_white,1200,1034,-166,1100
0188,vap,2719,2020,-699,2300
0188,vap_aian,23,13,-10,17
0188,vap_asian,49,79,30,67
0188,vap_black,1302,699,-603,940
0188,vap_hisp,127,135,8,132
0188,vap_nhpi,2,0,-2,1
0188,vap_other,2,21,19,13
0188,vap_two,36,56,20,48
0188,vap_white,1178,1017,-161,1081
0189,pop,1117,2019,902,1658
0189,pop_aian,3,14,11,10
0189,pop_asian,38,111,73,82
0189,pop_black,766,805,39,789
0189,pop_hisp,46,182,136,128
0189,pop_nhpi,0,0,0,0
0189,pop_other,0,5,5,3
0189,pop_two,19,54,35,40
0189,pop_white,244,848,604,606
0189,vap,925,1766,841,1430
0189,vap_aian,3,14,11,10
0189,vap_asian,29,95,66,69
0189,vap_black,612,645,33,632
0189,vap_hisp,33,153,120,105
0189,vap_nhpi,0,0,0,0
0189,vap_other,0,4,4,2
0189,vap_two,11,40,29,28
0189,vap_white,236,815,579,583
0190,pop,3130,3218,88,3183
0190,pop_aian,8,8,0,8
0190,pop_asian,226,281,55,259
0190,pop_black,258,256,-2,257
0190,pop_hisp,148,358,210,274
0190,pop_nhpi,1,0,-1,0
0190,pop_other,1,9,8,6
0190,pop_two,21,108,87,73
0190,pop_white,2465,2198,-267,2305
0190,vap,3113,3124,11,3120
0190,vap_aian,8,7,-1,7
0190,vap_asian,224,265,41,249
0190,vap_black,251,235,-16,241
0190,vap_hisp,147,332,185,258
0190,vap_nhpi,1,0,-1,0
0190,vap_other,1,7,6,5
0190,vap_two,20,99,79,67
0190,vap_white,2459,2179,-280,2291
0191,pop,2618,2754,136,2700
0191,pop_aian,3,5,2,4
0191,pop_asian,205,234,29,222
0191,pop_black,118,136,18,129
0191,pop_hisp,134,286,152,225
0191,pop_nhpi,2,1,-1,1
0191,pop_other,0,13,13,8
0191,pop_two,19,98,79,66
0191,pop_white,2137,1981,-156,2043
0191,vap,2602,2718,116,2672
0191,vap_aian,3,2,-1,2
0191,vap_asian,196,234,38,219
0191,vap_black,118,129,11,125
0191,vap_hisp,134,278,144,220
0191,vap_nhpi,2,1,-1,1
0191,vap_other,0,10,10,6
0191,vap_two,19,96,77,65
0191,vap_white,2130,1968,-162,2033
0192,pop,3253,2814,-439,2990
0192,pop_aian,9,7,-2,8
0192,pop_asian,100,195,95,157
0192,pop_black,1028,853,-175,923
0192,pop_hisp,161,299,138,244
0192,pop_nhpi,2,6,4,4
0192,pop_other,8,19,11,15
0192,pop_two,39,91,52,70
0192,pop_white,1905,1344,-561,1568
0192,vap,2797,2406,-391,2562
0192,vap_aian,8,4,-4,6
0192,vap_asian,100,182,82,149
0192,vap_black,642,550,-92,587
0192,vap_hisp,140,254,114,208
0192,vap_nhpi,2,6,4,4
0192,vap_other,8,17,9,13
0192,vap_two,28,75,47,56
0192,vap_white,1869,1318,-551,1538
0193,pop,2263,2010,-253,2111
0193,pop_aian,5,5,0,5
0193,pop_asian,332,330,-2,331
0193,pop_black,1493,1155,-338,1290
0193,pop_hisp,193,200,7,197
0193,pop_nhpi,0,0,0,0
0193,pop_other,10,3,-7,6
0193,pop_two,52,100,48,81
0193,pop_white,178,217,39,201
0193,vap,1450,1348,-102,1389
0193,vap_aian,4,3,-1,3
0193,vap_asian,227,234,7,231
0193,vap_black,904,735,-169,803
0193,vap_hisp,119,123,4,121
0193,vap_nhpi,0,0,0,0
0193,vap_other,4,0,-4,2
0193,vap_two,27,55,28,44
0193,vap_white,165,198,33,185
0194,pop,1359,1373,14,1367
0194,pop_aian,6,5,-1,5
0194,pop_asian,68,84,16,78
0194,pop_black,626,720,94,682
0194,pop_hisp,93,132,39,116
0194,pop_nhpi,3,1,-2,2
0194,pop_other,1,5,4,3
0194,pop_two,54,45,-9,49
0194,pop_white,508,381,-127,432
0194,vap,1202,1169,-33,1182
0194,vap_aian,5,5,0,5
0194,vap_asian,63,78,15,72
0194,vap_black,520,578,58,555
0194,vap_hisp,73,117,44,99
0194,vap_nhpi,3,1,-2,2
0194,vap_other,1,5,4,3
0194,vap_two,37,28,-9,32
0194,vap_white,500,357,-143,414
0195,pop,1457,1426,-31,1438
0195,pop_aian,14,5,-9,9
0195,pop_asian,24,34,10,30
0195,pop_black,1076,1022,-54,1044
0195,pop_hisp,112,152,40,136
0195,pop_nhpi,0,0,0,0
0195,pop_other,3,6,3,5
0195,pop_two,43,37,-6,39
0195,pop_white,184,170,-14,176
0195,vap,1112,1154,42,1137
0195,vap_aian,8,5,-3,6
0195,vap_asian,21,26,5,24
0195,vap_black,809,826,17,819
0195,vap_hisp,71,105,34,91
0195,vap_nhpi,0,0,0,0
0195,vap_other,3,6,3,5
0195,vap_two,22,26,4,24
0195,vap_white,177,160,-17,167
0196,pop,2456,2477,21,2469
0196,pop_aian,14,18,4,16
0196,pop_asian,167,134,-33,147
0196,pop_black,1412,1352,-60,1376
0196,pop_hisp,381,421,40,405
0196,pop_nhpi,4,4,0,4
0196,pop_other,2,22,20,14
0196,pop_two,80,123,43,106
0196,pop_white,396,403,7,400
0196,vap,1859,1893,34,1879
0196,vap_aian,11,11,0,11
0196,vap_asian,136,109,-27,120
0196,vap_black,1014,990,-24,1000
0196,vap_hisp,270,305,35,291
0196,vap_nhpi,3,2,-1,2
0196,vap_other,2,20,18,13
0196,vap_two,45,88,43,71
0196,vap_white,378,368,-10,372
0197,pop,1060,911,-149,971
0197,pop_aian,4,8,4,6
0197,pop_asian,102,78,-24,88
0197,pop_black,689,501,-188,576
0197,pop_hisp,134,170,36,156
0197,pop_nhpi,0,0,0,0
0197,pop_other,2,1,-1,1
0197,pop_two,37,46,9,42
0197,pop_white,92,107,15,101
0197,vap,775,663,-112,708
0197,vap_aian,4,3,-1,3
0197,vap_asian,73,65,-8,68
0197,vap_black,492,367,-125,417
0197,vap_hisp,93,103,10,99
0197,vap_nhpi,0,0,0,0
0197,vap_other,0,1,1,1
0197,vap_two,27,24,-3,25
0197,vap_white,86,100,14,94
0198,pop,2218,2172,-46,2190
0198,pop_aian,21,39,18,32
0198,pop_asian,4,24,20,16
0198,pop_black,1586,1290,-296,1408
0198,pop_hisp,212,319,107,276
0198,pop_nhpi,0,2,2,1
0198,pop_other,5,9,4,7
0198,pop_two,54,110,56,88
0198,pop_white,336,379,43,362
0198,vap,1750,1775,25,1765
0198,vap_aian,15,34,19,26
0198,vap_asian,3,22,19,14
0198,vap_black,1219,1068,-151,1128
0198,vap_hisp,164,235,71,207
0198,vap_nhpi,0,2,2,1
0198,vap_other,3,9,6,7
0198,vap_two,35,64,29,52
0198,vap_white,311,341,30,329
0199,pop,1599,1171,-428,1342
0199,pop_aian,19,15,-4,17
0199,pop_asian,13,12,-1,12
0199,pop_black,1134,804,-330,936
0199,pop_hisp,125,71,-54,93
0199,pop_nhpi,0,1,1,1
0199,pop_other,0,1,1,1
0199,pop_two,37,50,13,45
0199,pop_white,271,217,-54,239
0199,vap,1349,939,-410,1103
0199,vap_aian,17,6,-11,10
0199,vap_asian,11,6,-5,8
0199,vap_black,963,660,-303,781
0199,vap_hisp,86,45,-41,61
0199,vap_nhpi,0,0,0,0
0199,vap_other,0,1,1,1
0199,vap_two,20,28,8,25
0199,vap_white,252,193,-59,217
0200,pop,1019,945,-74,975
0200,pop_aian,2,1,-1,1
0200,pop_asian,61,129,68,102
0200,pop_black,688,551,-137,606
0200,pop_hisp,61,74,13,69
0200,pop_nhpi,0,0,0,0
0200,pop_other,3,1,-2,2
0200,pop_two,27,40,13,35
0200,pop_white,177,149,-28,160
0200,vap,685,606,-79,638
0200,vap_aian,1,0,-1,0
0200,vap_asian,39,67,28,56
0200,vap_black,430,362,-68,389
0200,vap_hisp,41,30,-11,34
0200,vap_nhpi,0,0,0,0
0200,vap_other,3,0,-3,1
0200,vap_two,16,12,-4,14
0200,vap_white,155,135,-20,143
0201,pop,1122,1070,-52,1091
0201,pop_aian,3,5,2,4
0201,pop_asian,85,145,60,121
0201,pop_black,769,533,-236,627
0201,pop_hisp,84,152,68,125
0201,pop_nhpi,0,0,0,0
0201,pop_other,4,6,2,5
0201,pop_two,44,60,16,54
0201,pop_white,133,169,36,155
0201,vap,800,806,6,804
0201,vap_aian,3,0,-3,1
0201,vap_asian,50,96,46,78
0201,vap_black,542,424,-118,471
0201,vap_hisp,51,102,51,82
0201,vap_nhpi,0,0,0,0
0201,vap_other,1,6,5,4
0201,vap_two,22,29,7,26
0201,vap_white,131,149,18,142
0202,pop,1669,1527,-142,1584
0202,pop_aian,27,10,-17,17
0202,pop_asian,150,129,-21,137
0202,pop_black,634,541,-93,578
0202,pop_hisp,163,155,-8,158
0202,pop_nhpi,0,0,0,0
0202,pop_other,5,6,1,6
0202,pop_two,81,109,28,98
0202,pop_white,609,577,-32,590
0202,vap,1245,1204,-41,1220
0202,vap_aian,21,10,-11,14
0202,vap_asian,97,87,-10,91
0202,vap_black,442,400,-42,417
0202,vap_hisp,100,109,9,105
0202,vap_nhpi,0,0,0,0
0202,vap_other,1,6,5,4
0202,vap_two,38,74,36,60
0202,vap_white,546,518,-28,529
0203,pop,1678,1673,-5,1675
0203,pop_aian,5,10,5,8
0203,pop_asian,23,38,15,32
0203,pop_black,316,286,-30,298
0203,pop_hisp,101,149,48,130
0203,pop_nhpi,0,0,0,0
0203,pop_other,7,5,-2,6
0203,pop_two,57,86,29,74
0203,pop_white,1169,1099,-70,1127
0203,vap,1323,1340,17,1333
0203,vap_aian,4,10,6,8
0203,vap_asian,14,28,14,22
0203,vap_black,220,223,3,222
0203,vap_hisp,65,97,32,84
0203,vap_nhpi,0,0,0,0
0203,vap_other,5,5,0,5
0203,vap_two,30,49,19,41
0203,vap_white,985,928,-57,951
0204,pop,1360,1332,-28,1343
0204,pop_aian,11,5,-6,7
0204,pop_asian,22,23,1,23
0204,pop_black,168,127,-41,143
0204,pop_hisp,67,107,40,91
0204,pop_nhpi,0,0,0,0
0204,pop_other,0,6,6,4
0204,pop_two,33,71,38,56
0204,pop_white,1059,993,-66,1019
0204,vap,1077,1114,37,1099
0204,vap_aian,5,4,-1,4
0204,vap_asian,15,23,8,20
0204,vap_black,116,95,-21,103
0204,vap_hisp,41,72,31,60
0204,vap_nhpi,0,0,0,0
0204,vap_other,0,5,5,3
0204,vap_two,15,46,31,34
0204,vap_white,885,869,-16,875
0205,pop,1310,1200,-110,1244
0205,pop_aian,11,14,3,13
0205,pop_asian,43,33,-10,37
0205,pop_black,125,115,-10,119
0205,pop_hisp,72,91,19,83
0205,pop_nhpi,0,0,0,0
0205,pop_other,2,3,1,3
0205,pop_two,29,70,41,54
0205,pop_white,1028,874,-154,936
0205,vap,1095,1005,-90,1041
0205,vap_aian,5,12,7,9
0205,vap_asian,34,31,-3,32
0205,vap_black,97,90,-7,93
0205,vap_hisp,56,51,-5,53
0205,vap_nhpi,0,0,0,0
0205,vap_other,2,3,1,3
0205,vap_two,13,32,19,24
0205,vap_white,888,786,-102,827
0206,pop,998,1005,7,1002
0206,pop_aian,4,5,1,5
0206,pop_asian,7,21,14,15
0206,pop_black,40,52,12,47
0206,pop_hisp,55,76,21,68
0206,pop_nhpi,1,0,-1,0
0206,pop_other,3,9,6,7
0206,pop_two,23,44,21,36
0206,pop_white,865,798,-67,825
0206,vap,774,819,45,801
0206,vap_aian,3,1,-2,2
0206,vap_asian,6,21,15,15
0206,vap_black,23,44,21,36
0206,vap_hisp,32,53,21,45
0206,vap_nhpi,1,0,-1,0
0206,vap_other,3,5,2,4
0206,vap_two,15,30,15,24
0206,vap_white,691,665,-26,675
0207,pop,1367,1344,-23,1353
0207,pop_aian,9,13,4,11
0207,pop_asian,23,14,-9,18
0207,pop_black,83,126,43,109
0207,pop_hisp,137,202,65,176
0207,pop_nhpi,0,0,0,0
0207,pop_other,7,7,0,7
0207,pop_two,33,68,35,54
0207,pop_white,1075,914,-161,978
0207,vap,1107,1115,8,1112
0207,vap_aian,9,9,0,9
0207,vap_asian,22,10,-12,15
0207,vap_black,58,92,34,78
0207,vap_hisp,76,143,67,116
0207,vap_nhpi,0,0,0,0
0207,vap_other,4,3,-1,3
0207,vap_two,17,36,19,28
0207,vap_white,921,822,-99,862
0208,pop,1415,1505,90,1469
0208,pop_aian,4,19,15,13
0208,pop_asian,19,34,15,28
0208,pop_black,84,167,83,134
0208,pop_hisp,118,164,46,146
0208,pop_nhpi,1,1,0,1
0208,pop_other,0,5,5,3
0208,pop_two,35,105,70,77
0208,pop_white,1154,1010,-144,1068
0208,vap,1152,1195,43,1178
0208,vap_aian,4,16,12,11
0208,vap_asian,15,28,13,23
0208,vap_black,53,108,55,86
0208,vap_hisp,74,108,34,94
0208,vap_nhpi,1,1,0,1
0208,vap_other,0,2,2,1
0208,vap_two,10,52,42,35
0208,vap_white,995,880,-115,926
0209,pop,1277,1395,118,1348
0209,pop_aian,12,1,-11,5
0209,pop_asian,14,34,20,26
0209,pop_black,32,82,50,62
0209,pop_hisp,90,137,47,118
0209,pop_nhpi,0,0,0,0
0209,pop_other,2,17,15,11
0209,pop_two,18,52,34,38
0209,pop_white,1109,1072,-37,1087
0209,vap,1064,1193,129,1141
0209,vap_aian,8,0,-8,3
0209,vap_asian,7,34,27,23
0209,vap_black,21,63,42,46
0209,vap_hisp,52,96,44,78
0209,vap_nhpi,0,0,0,0
0209,vap_other,0,12,12,7
0209,vap_two,8,21,13,16
0209,vap_white,968,967,-1,967
0210,pop,1342,1513,171,1445
0210,pop_aian,6,7,1,7
0210,pop_asian,54,63,9,59
0210,pop_black,53,61,8,58
0210,pop_hisp,63,125,62,100
0210,pop_nhpi,0,1,1,1
0210,pop_other,2,8,6,6
0210,pop_two,16,67,51,47
0210,pop_white,1148,1181,33,1168
0210,vap,1215,1372,157,1309
0210,vap_aian,4,7,3,6
0210,vap_asian,49,62,13,57
0210,vap_black,35,51,16,45
0210,vap_hisp,44,94,50,74
0210,vap_nhpi,0,1,1,1
0210,vap_other,0,8,8,5
0210,vap_two,11,48,37,33
0210,vap_white,1072,1101,29,1089
0211,pop,1616,1539,-77,1570
0211,pop_aian,6,11,5,9
0211,pop_asian,82,47,-35,61
0211,pop_black,130,210,80,178
0211,pop_hisp,189,201,12,196
0211,pop_nhpi,0,0,0,0
0211,pop_other,1,15,14,9
0211,pop_two,21,78,57,55
0211,pop_white,1187,977,-210,1061
0211,vap,1241,1247,6,1245
0211,vap_aian,5,6,1,6
0211,vap_asian,70,43,-27,54
0211,vap_black,76,136,60,112
0211,vap_hisp,108,130,22,121
0211,vap_nhpi,0,0,0,0
0211,vap_other,1,14,13,9
0211,vap_two,8,54,46,36
0211,vap_white,973,864,-109,908
0212,pop,1869,1891,22,1882
0212,pop_aian,37,25,-12,30
0212,pop_asian,25,24,-1,24
0212,pop_black,118,124,6,122
0212,pop_hisp,305,590,285,476
0212,pop_nhpi,0,0,0,0
0212,pop_other,0,5,5,3
0212,pop_two,78,86,8,83
0212,pop_white,1306,1037,-269,1145
0212,vap,1429,1421,-8,1424
0212,vap_aian,26,21,-5,23
0212,vap_asian,19,18,-1,18
0212,vap_black,66,82,16,76
0212,vap_hisp,184,360,176,290
0212,vap_nhpi,0,0,0,0
0212,vap_other,0,5,5,3
0212,vap_two,34,50,16,44
0212,vap_white,1100,885,-215,971
0213,pop,2228,1983,-245,2081
0213,pop_aian,21,14,-7,17
0213,pop_asian,22,41,19,33
0213,pop_black,252,254,2,253
0213,pop_hisp,351,512,161,448
0213,pop_nhpi,1,0,-1,0
0213,pop_other,4,15,11,11
0213,pop_two,69,116,47,97
0213,pop_white,1508,1031,-477,1222
0213,vap,1799,1522,-277,1633
0213,vap_aian,18,12,-6,14
0213,vap_asian,17,33,16,27
0213,vap_black,217,170,-47,189
0213,vap_hisp,205,322,117,275
0213,vap_nhpi,1,0,-1,0
0213,vap_other,2,9,7,6
0213,vap_two,29,57,28,46
0213,vap_white,1310,919,-391,1075
0214,pop,1066,1002,-64,1028
0214,pop_aian,12,11,-1,11
0214,pop_asian,109,76,-33,89
0214,pop_black,286,294,8,291
0214,pop_hisp,166,190,24,180
0214,pop_nhpi,0,2,2,1
0214,pop_other,1,8,7,5
0214,pop_two,53,85,32,72
0214,pop_white,439,336,-103,377
0214,vap,767,765,-2,766
0214,vap_aian,10,7,-3,8
0214,vap_asian,60,52,-8,55
0214,vap_black,186,203,17,196
0214,vap_hisp,102,134,32,121
0214,vap_nhpi,0,2,2,1
0214,vap_other,1,5,4,3
0214,vap_two,20,44,24,34
0214,vap_white,388,318,-70,346
0215,pop,1592,1640,48,1621
0215,pop_aian,32,17,-15,23
0215,pop_asian,81,85,4,83
0215,pop_black,164,228,64,202
0215,pop_hisp,924,1011,87,976
0215,pop_nhpi,0,1,1,1
0215,pop_other,3,5,2,4
0215,pop_two,42,67,25,57
0215,pop_white,346,226,-120,274
0215,vap,1035,1082,47,1063
0215,vap_aian,28,15,-13,20
0215,vap_asian,52,66,14,60
0215,vap_black,92,129,37,114
0215,vap_hisp,539,642,103,601
0215,vap_nhpi,0,1,1,1
0215,vap_other,3,5,2,4
0215,vap_two,20,33,13,28
0215,vap_white,301,191,-110,235
0216,pop,1493,1300,-193,1377
0216,pop_aian,27,10,-17,17
0216,pop_asian,61,77,16,71
0216,pop_black,94,84,-10,88
0216,pop_hisp,994,890,-104,932
0216,pop_nhpi,0,1,1,1
0216,pop_other,0,4,4,2
0216,pop_two,42,29,-13,34
0216,pop_white,275,205,-70,233
0216,vap,997,909,-88,944
0216,vap_aian,23,9,-14,15
0216,vap_asian,42,63,21,55
0216,vap_black,66,52,-14,58
0216,vap_hisp,602,595,-7,598
0216,vap_nhpi,0,0,0,0
0216,vap_other,0,2,2,1
0216,vap_two,18,15,-3,16
0216,vap_white,246,173,-73,202
0217,pop,2451,2401,-50,2421
0217,pop_aian,22,6,-16,12
0217,pop_asian,111,121,10,117
0217,pop_black,58,53,-5,55
0217,pop_hisp,1681,1824,143,1767
0217,pop_nhpi,0,0,0,0
0217,pop_other,0,17,17,10
0217,pop_two,28,39,11,35
0217,pop_white,551,341,-210,425
0217,vap,1618,1674,56,1652
0217,vap_aian,18,5,-13,10
0217,vap_asian,81,97,16,91
0217,vap_black,43,40,-3,41
0217,vap_hisp,993,1202,209,1118
0217,vap_nhpi,0,0,0,0
0217,vap_other,0,14,14,8
0217,vap_two,18,17,-1,17
0217,vap_white,465,299,-166,365
0218,pop,3350,3176,-174,3246
0218,pop_aian,32,13,-19,21
0218,pop_asian,124,78,-46,96
0218,pop_black,87,80,-7,83
0218,pop_hisp,2495,2620,125,2570
0218,pop_nhpi,0,2,2,1
0218,pop_other,0,7,7,4
0218,pop_two,44,42,-2,43
0218,pop_white,568,334,-234,428
0218,vap,2079,2095,16,2089
0218,vap_aian,22,12,-10,16
0218,vap_asian,87,52,-35,66
0218,vap_black,52,45,-7,48
0218,vap_hisp,1413,1665,252,1564
0218,vap_nhpi,0,2,2,1
0218,vap_other,0,6,6,4
0218,vap_two,17,23,6,21
0218,vap_white,488,290,-198,369
0219,pop,2306,1890,-416,2056
0219,pop_aian,33,25,-8,28
0219,pop_asian,94,65,-29,77
0219,pop_black,114,70,-44,88
0219,pop_hisp,1592,1422,-170,1490
0219,pop_nhpi,0,0,0,0
0219,pop_other,1,4,3,3
0219,pop_two,33,46,13,41
0219,pop_white,439,258,-181,330
0219,vap,1464,1294,-170,1362
0219,vap_aian,23,23,0,23
0219,vap_asian,61,52,-9,56
0219,vap_black,75,63,-12,68
0219,vap_hisp,929,908,-21,916
0219,vap_nhpi,0,0,0,0
0219,vap_other,0,3,3,2
0219,vap_two,10,13,3,12
0219,vap_white,366,232,-134,286
0220,pop,2047,1948,-99,1988
0220,pop_aian,17,19,2,18
0220,pop_asian,124,67,-57,90
0220,pop_black,51,37,-14,43
0220,pop_hisp,1442,1516,74,1486
0220,pop_nhpi,0,0,0,0
0220,pop_other,0,2,2,1
0220,pop_two,28,43,15,37
0220,pop_white,385,264,-121,312
0220,vap,1367,1372,5,1370
0220,vap_aian,12,12,0,12
0220,vap_asian,85,63,-22,72
0220,vap_black,33,28,-5,30
0220,vap_hisp,896,1020,124,970
0220,vap_nhpi,0,0,0,0
0220,vap_other,0,1,1,1
0220,vap_two,9,32,23,23
0220,vap_white,332,216,-116,262
0221,pop,3772,3615,-157,3678
0221,pop_aian,36,26,-10,30
0221,pop_asian,144,106,-38,121
0221,pop_black,213,201,-12,206
0221,pop_hisp,2378,2493,115,2447
0221,pop_nhpi,0,1,1,1
0221,pop_other,2,5,3,4
0221,pop_two,52,70,18,63
0221,pop_white,947,713,-234,807
0221,vap,2532,2562,30,2550
0221,vap_aian,27,19,-8,22
0221,vap_asian,107,81,-26,91
0221,vap_black,139,141,2,140
0221,vap_hisp,1399,1622,223,1533
0221,vap_nhpi,0,1,1,1
0221,vap_other,2,4,2,3
0221,vap_two,20,39,19,31
0221,vap_white,838,655,-183,728
0222,pop,2962,2860,-102,2901
0222,pop_aian,52,22,-30,34
0222,pop_asian,101,155,54,133
0222,pop_black,207,247,40,231
0222,pop_hisp,2093,2065,-28,2076
0222,pop_nhpi,1,2,1,2
0222,pop_other,1,20,19,12
0222,pop_two,51,51,0,51
0222,pop_white,457,298,-159,362
0222,vap,1919,1905,-14,1911
0222,vap_aian,34,20,-14,26
0222,vap_asian,66,101,35,87
0222,vap_black,117,168,51,148
0222,vap_hisp,1283,1315,32,1302
0222,vap_nhpi,1,2,1,2
0222,vap_other,0,11,11,7
0222,vap_two,20,27,7,24
0222,vap_white,398,261,-137,316
0223,pop,3194,2931,-263,3036
0223,pop_aian,49,18,-31,30
0223,pop_asian,48,99,51,79
0223,pop_black,120,100,-20,108
0223,pop_hisp,2388,2257,-131,2309
0223,pop_nhpi,0,2,2,1
0223,pop_other,3,3,0,3
0223,pop_two,52,54,2,53
0223,pop_white,534,398,-136,452
0223,vap,2068,1914,-154,1976
0223,vap_aian,36,10,-26,20
0223,vap_asian,34,69,35,55
0223,vap_black,64,65,1,65
0223,vap_hisp,1431,1418,-13,1423
0223,vap_nhpi,0,2,2,1
0223,vap_other,3,3,0,3
0223,vap_two,26,20,-6,22
0223,vap_white,474,327,-147,386
0224,pop,2914,2713,-201,2793
0224,pop_aian,27,41,14,35
0224,pop_asian,52,62,10,58
0224,pop_black,157,186,29,174
0224,pop_hisp,2113,2012,-101,2052
0224,pop_nhpi,0,0,0,0
0224,pop_other,3,4,1,4
0224,pop_two,54,63,9,59
0224,pop_white,508,345,-163,410
0224,vap,1860,1833,-27,1844
0224,vap_aian,19,25,6,23
0224,vap_asian,33,44,11,40
0224,vap_black,96,121,25,111
0224,vap_hisp,1236,1311,75,1281
0224,vap_nhpi,0,0,0,0
0224,vap_other,3,2,-1,2
0224,vap_two,29,29,0,29
0224,vap_white,444,301,-143,358
0225,pop,2977,2751,-226,2841
0225,pop_aian,26,12,-14,18
0225,pop_asian,53,152,99,112
0225,pop_black,396,243,-153,304
0225,pop_hisp,2081,2010,-71,2038
0225,pop_nhpi,1,0,-1,0
0225,pop_other,1,7,6,5
0225,pop_two,50,76,26,66
0225,pop_white,369,251,-118,298
0225,vap,1812,1732,-80,1764
0225,vap_aian,16,7,-9,11
0225,vap_asian,28,88,60,64
0225,vap_black,198,133,-65,159
0225,vap_hisp,1237,1268,31,1256
0225,vap_nhpi,1,0,-1,0
0225,vap_other,0,2,2,1
0225,vap_two,19,27,8,24
0225,vap_white,313,207,-106,249
0226,pop,1493,1360,-133,1413
0226,pop_aian,20,16,-4,18
0226,pop_asian,31,49,18,42
0226,pop_black,165,132,-33,145
0226,pop_hisp,998,986,-12,991
0226,pop_nhpi,1,0,-1,0
0226,pop_other,8,2,-6,4
0226,pop_two,39,26,-13,31
0226,pop_white,231,149,-82,182
0226,vap,969,887,-82,920
0226,vap_aian,13,10,-3,11
0226,vap_asian,21,37,16,31
0226,vap_black,111,92,-19,100
0226,vap_hisp,610,608,-2,609
0226,vap_nhpi,1,0,-1,0
0226,vap_other,4,1,-3,2
0226,vap_two,16,17,1,17
0226,vap_white,193,122,-71,150
0227,pop,2671,2508,-163,2573
0227,pop_aian,29,15,-14,21
0227,pop_asian,131,56,-75,86
0227,pop_black,479,574,95,536
0227,pop_hisp,1336,1408,72,1379
0227,pop_nhpi,0,6,6,4
0227,pop_other,0,14,14,8
0227,pop_two,57,79,22,70
0227,pop_white,639,356,-283,469
0227,vap,2025,1943,-82,1976
0227,vap_aian,26,13,-13,18
0227,vap_asian,104,49,-55,71
0227,vap_black,382,480,98,441
0227,vap_hisp,880,989,109,945
0227,vap_nhpi,0,5,5,3
0227,vap_other,0,9,9,5
0227,vap_two,32,58,26,48
0227,vap_white,601,340,-261,444
0228,pop,2113,1959,-154,2021
0228,pop_aian,10,4,-6,6
0228,pop_asian,53,72,19,64
0228,pop_black,271,133,-138,188
0228,pop_hisp,1502,1508,6,1506
0228,pop_nhpi,1,1,0,1
0228,pop_other,0,4,4,2
0228,pop_two,26,35,9,31
0228,pop_white,250,202,-48,221
0228,vap,1422,1257,-165,1323
0228,vap_aian,7,4,-3,5
0228,vap_asian,37,59,22,50
0228,vap_black,160,98,-62,123
0228,vap_hisp,995,919,-76,949
0228,vap_nhpi,1,1,0,1
0228,vap_other,0,2,2,1
0228,vap_two,13,21,8,18
0228,vap_white,209,153,-56,175
0229,pop,2160,2058,-102,2099
0229,pop_aian,5,14,9,10
0229,pop_asian,39,94,55,72
0229,pop_black,186,153,-33,166
0229,pop_hisp,1622,1559,-63,1584
0229,pop_nhpi,0,1,1,1
0229,pop_other,3,13,10,9
0229,pop_two,37,49,12,44
0229,pop_white,269,175,-94,213
0229,vap,1369,1360,-9,1364
0229,vap_aian,3,9,6,7
0229,vap_asian,26,57,31,45
0229,vap_black,112,93,-19,101
0229,vap_hisp,995,1021,26,1011
0229,vap_nhpi,0,1,1,1
0229,vap_other,0,9,9,5
0229,vap_two,14,34,20,26
0229,vap_white,219,136,-83,169
0230,pop,3201,2932,-269,3040
0230,pop_aian,27,7,-20,15
0230,pop_asian,66,108,42,91
0230,pop_black,308,280,-28,291
0230,pop_hisp,2344,2162,-182,2235
0230,pop_nhpi,0,0,0,0
0230,pop_other,2,10,8,7
0230,pop_two,44,73,29,61
0230,pop_white,410,292,-118,339
0230,vap,2052,1972,-80,2004
0230,vap_aian,23,7,-16,13
0230,vap_asian,40,54,14,48
0230,vap_black,183,191,8,188
0230,vap_hisp,1443,1430,-13,1435
0230,vap_nhpi,0,0,0,0
0230,vap_other,2,6,4,4
0230,vap_two,14,37,23,28
0230,vap_white,347,247,-100,287
0231,pop,1947,1739,-208,1822
0231,pop_aian,6,11,5,9
0231,pop_asian,54,73,19,65
0231,pop_black,190,130,-60,154
0231,pop_hisp,1506,1383,-123,1432
0231,pop_nhpi,1,0,-1,0
0231,pop_other,5,6,1,6
0231,pop_two,21,31,10,27
0231,pop_white,164,105,-59,129
0231,vap,1210,1073,-137,1128
0231,vap_aian,6,5,-1,5
0231,vap_asian,37,44,7,41
0231,vap_black,108,87,-21,95
0231,vap_hisp,907,821,-86,855
0231,vap_nhpi,1,0,-1,0
0231,vap_other,4,0,-4,2
0231,vap_two,9,20,11,16
0231,vap_white,138,96,-42,113
0232,pop,1860,1601,-259,1705
0232,pop_aian,22,13,-9,17
0232,pop_asian,18,76,58,53
0232,pop_black,212,139,-73,168
0232,pop_hisp,1457,1225,-232,1318
0232,pop_nhpi,1,2,1,2
0232,pop_other,0,8,8,5
0232,pop_two,11,11,0,11
0232,pop_white,139,127,-12,132
0232,vap,1190,1063,-127,1114
0232,vap_aian,14,10,-4,12
0232,vap_asian,13,41,28,30
0232,vap_black,118,86,-32,99
0232,vap_hisp,927,809,-118,856
0232,vap_nhpi,1,2,1,2
0232,vap_other,0,7,7,4
0232,vap_two,5,5,0,5
0232,vap_white,112,103,-9,107
0233,pop,1365,1211,-154,1273
0233,pop_aian,7,8,1,8
0233,pop_asian,11,18,7,15
0233,pop_black,153,66,-87,101
0233,pop_hisp,1058,994,-64,1020
0233,pop_nhpi,0,0,0,0
0233,pop_other,9,0,-9,4
0233,pop_two,13,19,6,17
0233,pop_white,114,106,-8,109
0233,vap,900,804,-96,842
0233,vap_aian,7,8,1,8
0233,vap_asian,11,5,-6,7
0233,vap_black,77,47,-30,59
0233,vap_hisp,700,644,-56,666
0233,vap_nhpi,0,0,0,0
0233,vap_other,3,0,-3,1
0233,vap_two,5,11,6,9
0233,vap_white,97,89,-8,92
0234,pop,1290,1759,469,1571
0234,pop_aian,5,6,1,6
0234,pop_asian,4,16,12,11
0234,pop_black,134,279,145,221
0234,pop_hisp,947,927,-20,935
0234,pop_nhpi,0,1,1,1
0234,pop_other,4,7,3,6
0234,pop_two,22,46,24,36
0234,pop_white,174,477,303,356
0234,vap,852,1301,449,1121
0234,vap_aian,4,4,0,4
0234,vap_asian,4,14,10,10
0234,vap_black,80,162,82,129
0234,vap_hisp,604,631,27,620
0234,vap_nhpi,0,0,0,0
0234,vap_other,4,1,-3,2
0234,vap_two,9,37,28,26
0234,vap_white,147,452,305,330
0235,pop,1941,2939,998,2540
0235,pop_aian,22,12,-10,16
0235,pop_asian,26,100,74,70
0235,pop_black,153,228,75,198
0235,pop_hisp,584,633,49,613
0235,pop_nhpi,1,0,-1,0
0235,pop_other,3,11,8,8
0235,pop_two,31,115,84,81
0235,pop_white,1121,1840,719,1552
0235,vap,1680,2631,951,2251
0235,vap_aian,17,12,-5,14
0235,vap_asian,26,95,69,67
0235,vap_black,124,165,41,149
0235,vap_hisp,417,478,61,454
0235,vap_nhpi,1,0,-1,0
0235,vap_other,3,10,7,7
0235,vap_two,22,108,86,74
0235,vap_white,1070,1763,693,1486
0236,pop,2263,1908,-355,2050
0236,pop_aian,17,20,3,19
0236,pop_asian,68,34,-34,48
0236,pop_black,195,216,21,208
0236,pop_hisp,1715,1434,-281,1546
0236,pop_nhpi,0,0,0,0
0236,pop_other,0,9,9,5
0236,pop_two,27,33,6,31
0236,pop_white,241,162,-79,194
0236,vap,1528,1375,-153,1436
0236,vap_aian,13,19,6,17
0236,vap_asian,40,21,-19,29
0236,vap_black,120,172,52,151
0236,vap_hisp,1131,988,-143,1045
0236,vap_nhpi,0,0,0,0
0236,vap_other,0,2,2,1
0236,vap_two,9,23,14,17
0236,vap_white,215,150,-65,176
0237,pop,3033,2611,-422,2780
0237,pop_aian,21,36,15,30
0237,pop_asian,32,53,21,45
0237,pop_black,303,317,14,311
0237,pop_hisp,2332,1926,-406,2088
0237,pop_nhpi,5,0,-5,2
0237,pop_other,4,5,1,5
0237,pop_two,35,29,-6,31
0237,pop_white,301,245,-56,267
0237,vap,1992,1826,-166,1892
0237,vap_aian,15,32,17,25
0237,vap_asian,22,33,11,29
0237,vap_black,197,235,38,220
0237,vap_hisp,1465,1286,-179,1358
0237,vap_nhpi,4,0,-4,2
0237,vap_other,2,1,-1,1
0237,vap_two,19,24,5,22
0237,vap_white,268,215,-53,236
0238,pop,2831,2547,-284,2661
0238,pop_aian,23,10,-13,15
0238,pop_asian,41,109,68,82
0238,pop_black,264,204,-60,228
0238,pop_hisp,2093,2004,-89,2040
0238,pop_nhpi,0,0,0,0
0238,pop_other,0,12,12,7
0238,pop_two,44,34,-10,38
0238,pop_white,366,174,-192,251
0238,vap,1742,1677,-65,1703
0238,vap_aian,16,9,-7,12
0238,vap_asian,21,72,51,52
0238,vap_black,146,119,-27,130
0238,vap_hisp,1259,1302,43,1285
0238,vap_nhpi,0,0,0,0
0238,vap_other,0,4,4,2
0238,vap_two,14,13,-1,13
0238,vap_white,286,158,-128,209
0239,pop,2296,1994,-302,2115
0239,pop_aian,31,14,-17,21
0239,pop_asian,18,48,30,36
0239,pop_black,224,139,-85,173
0239,pop_hisp,1675,1449,-226,1539
0239,pop_nhpi,0,0,0,0
0239,pop_other,8,8,0,8
0239,pop_two,30,62,32,49
0239,pop_white,310,274,-36,288
0239,vap,1506,1363,-143,1420
0239,vap_aian,27,14,-13,19
0239,vap_asian,17,26,9,22
0239,vap_black,126,100,-26,110
0239,vap_hisp,1038,937,-101,977
0239,vap_nhpi,0,0,0,0
0239,vap_other,8,8,0,8
0239,vap_two,14,36,22,27
0239,vap_white,276,242,-34,256
0240,pop,2262,2074,-188,2149
0240,pop_aian,27,10,-17,17
0240,pop_asian,15,48,33,35
0240,pop_black,342,357,15,351
0240,pop_hisp,1479,1245,-234,1339
0240,pop_nhpi,0,0,0,0
0240,pop_other,3,14,11,10
0240,pop_two,51,50,-1,50
0240,pop_white,345,350,5,348
0240,vap,1520,1445,-75,1475
0240,vap_aian,21,9,-12,14
0240,vap_asian,11,29,18,22
0240,vap_black,193,210,17,203
0240,vap_hisp,959,844,-115,890
0240,vap_nhpi,0,0,0,0
0240,vap_other,1,12,11,8
0240,vap_two,26,24,-2,25
0240,vap_white,309,317,8,314
0241,pop,1704,1991,287,1876
0241,pop_aian,19,11,-8,14
0241,pop_asian,22,61,39,45
0241,pop_black,61,55,-6,57
0241,pop_hisp,297,301,4,299
0241,pop_nhpi,0,0,0,0
0241,pop_other,1,10,9,6
0241,pop_two,33,60,27,49
0241,pop_white,1271,1493,222,1404
0241,vap,1459,1794,335,1660
0241,vap_aian,14,8,-6,10
0241,vap_asian,17,45,28,34
0241,vap_black,48,41,-7,44
0241,vap_hisp,209,246,37,231
0241,vap_nhpi,0,0,0,0
0241,vap_other,0,10,10,6
0241,vap_two,19,51,32,38
0241,vap_white,1152,1393,241,1297
0242,pop,1318,1361,43,1344
0242,pop_aian,21,8,-13,13
0242,pop_asian,7,27,20,19
0242,pop_black,41,34,-7,37
0242,pop_hisp,111,217,106,175
0242,pop_nhpi,1,1,0,1
0242,pop_other,2,3,1,3
0242,pop_two,45,77,32,64
0242,pop_white,1090,994,-96,1032
0242,vap,1133,1176,43,1159
0242,vap_aian,13,8,-5,10
0242,vap_asian,7,26,19,18
0242,vap_black,28,29,1,29
0242,vap_hisp,75,139,64,113
0242,vap_nhpi,1,1,0,1
0242,vap_other,1,3,2,2
0242,vap_two,20,50,30,38
0242,vap_white,988,920,-68,947
0243,pop,1395,1406,11,1402
0243,pop_aian,7,3,-4,5
0243,pop_asian,19,22,3,21
0243,pop_black,15,10,-5,12
0243,pop_hisp,85,117,32,104
0243,pop_nhpi,1,0,-1,0
0243,pop_other,4,9,5,7
0243,pop_two,21,54,33,41
0243,pop_white,1243,1191,-52,1212
0243,vap,1222,1216,-6,1218
0243,vap_aian,6,0,-6,2
0243,vap_asian,15,17,2,16
0243,vap_black,11,8,-3,9
0243,vap_hisp,58,77,19,69
0243,vap_nhpi,1,0,-1,0
0243,vap_other,2,4,2,3
0243,vap_two,11,38,27,27
0243,vap_white,1118,1072,-46,1090
0244,pop,1298,1207,-91,1243
0244,pop_aian,6,4,-2,5
0244,pop_asian,11,17,6,15
0244,pop_black,19,38,19,30
0244,pop_hisp,136,107,-29,119
0244,pop_nhpi,1,0,-1,0
0244,pop_other,0,2,2,1
0244,pop_two,43,56,13,51
0244,pop_white,1082,983,-99,1023
0244,vap,1047,1020,-27,1031
0244,vap_aian,5,4,-1,4
0244,vap_asian,9,17,8,14
0244,vap_black,9,23,14,17
0244,vap_hisp,83,87,4,85
0244,vap_nhpi,1,0,-1,0
0244,vap_other,0,1,1,1
0244,vap_two,13,30,17,23
0244,vap_white,927,858,-69,886
0245,pop,1007,974,-33,987
0245,pop_aian,0,1,1,1
0245,pop_asian,10,10,0,10
0245,pop_black,16,19,3,18
0245,pop_hisp,64,82,18,75
0245,pop_nhpi,0,0,0,0
0245,pop_other,0,5,5,3
0245,pop_two,19,33,14,27
0245,pop_white,898,824,-74,854
0245,vap,850,832,-18,839
0245,vap_aian,0,1,1,1
0245,vap_asian,10,9,-1,9
0245,vap_black,7,19,12,14
0245,vap_hisp,42,56,14,50
0245,vap_nhpi,0,0,0,0
0245,vap_other,0,3,3,2
0245,vap_two,11,19,8,16
0245,vap_white,780,725,-55,747
0246,pop,1893,1781,-112,1826
0246,pop_aian,18,18,0,18
0246,pop_asian,13,19,6,17
0246,pop_black,49,19,-30,31
0246,pop_hisp,173,173,0,173
0246,pop_nhpi,3,1,-2,2
0246,pop_other,0,9,9,5
0246,pop_two,44,106,62,81
0246,pop_white,1593,1436,-157,1499
0246,vap,1571,1515,-56,1537
0246,vap_aian,14,15,1,15
0246,vap_asian,11,14,3,13
0246,vap_black,23,12,-11,16
0246,vap_hisp,114,133,19,125
0246,vap_nhpi,3,1,-2,2
0246,vap_other,0,7,7,4
0246,vap_two,29,64,35,50
0246,vap_white,1377,1269,-108,1312
0247,pop,1060,955,-105,997
0247,pop_aian,7,1,-6,3
0247,pop_asian,7,10,3,9
0247,pop_black,24,27,3,26
0247,pop_hisp,182,142,-40,158
0247,pop_nhpi,0,0,0,0
0247,pop_other,0,8,8,5
0247,pop_two,34,42,8,39
0247,pop_white,806,725,-81,757
0247,vap,832,787,-45,805
0247,vap_aian,7,0,-7,3
0247,vap_asian,6,7,1,7
0247,vap_black,14,22,8,19
0247,vap_hisp,107,102,-5,104
0247,vap_nhpi,0,0,0,0
0247,vap_other,0,2,2,1
0247,vap_two,14,25,11,21
0247,vap_white,684,629,-55,651
0248,pop,2161,1974,-187,2049
0248,pop_aian,29,18,-11,22
0248,pop_asian,43,47,4,45
0248,pop_black,115,76,-39,92
0248,pop_hisp,407,320,-87,355
0248,pop_nhpi,2,0,-2,1
0248,pop_other,1,8,7,5
0248,pop_two,81,70,-11,74
0248,pop_white,1483,1435,-48,1454
0248,vap,1774,1700,-74,1730
0248,vap_aian,19,14,-5,16
0248,vap_asian,39,43,4,41
0248,vap_black,92,60,-32,73
0248,vap_hisp,264,233,-31,245
0248,vap_nhpi,2,0,-2,1
0248,vap_other,1,8,7,5
0248,vap_two,42,54,12,49
0248,vap_white,1315,1288,-27,1299
0249,pop,2062,1858,-204,1940
0249,pop_aian,33,13,-20,21
0249,pop_asian,17,9,-8,12
0249,pop_black,206,192,-14,198
0249,pop_hisp,1222,1201,-21,1209
0249,pop_nhpi,14,2,-12,7
0249,pop_other,8,11,3,10
0249,pop_two,57,60,3,59
0249,pop_white,505,370,-135,424
0249,vap,1299,1203,-96,1241
0249,vap_aian,19,8,-11,12
0249,vap_asian,14,6,-8,9
0249,vap_black,118,125,7,122
0249,vap_hisp,696,735,39,719
0249,vap_nhpi,6,1,-5,3
0249,vap_other,0,6,6,4
0249,vap_two,20,31,11,27
0249,vap_white,426,291,-135,345
0250,pop,1749,1500,-249,1600
0250,pop_aian,15,12,-3,13
0250,pop_asian,45,95,50,75
0250,pop_black,91,89,-2,90
0250,pop_hisp,1270,1070,-200,1150
0250,pop_nhpi,0,0,0,0
0250,pop_other,1,5,4,3
0250,pop_two,19,25,6,23
0250,pop_white,308,204,-104,246
0250,vap,1105,1007,-98,1046
0250,vap_aian,8,10,2,9
0250,vap_asian,28,50,22,41
0250,vap_black,53,52,-1,52
0250,vap_hisp,745,696,-49,716
0250,vap_nhpi,0,0,0,0
0250,vap_other,0,2,2,1
0250,vap_two,7,18,11,14
0250,vap_white,264,179,-85,213
0251,pop,1476,1368,-108,1411
0251,pop_aian,23,14,-9,18
0251,pop_asian,43,42,-1,42
0251,pop_black,74,80,6,78
0251,pop_hisp,1107,1061,-46,1079
0251,pop_nhpi,0,0,0,0
0251,pop_other,0,5,5,3
0251,pop_two,26,28,2,27
0251,pop_white,203,138,-65,164
0251,vap,893,882,-11,886
0251,vap_aian,13,14,1,14
0251,vap_asian,29,23,-6,25
0251,vap_black,49,50,1,50
0251,vap_hisp,623,655,32,642
0251,vap_nhpi,0,0,0,0
0251,vap_other,0,5,5,3
0251,vap_two,11,15,4,13
0251,vap_white,168,120,-48,139
0252,pop,2551,2132,-419,2300
0252,pop_aian,34,11,-23,20
0252,pop_asian,9,144,135,90
0252,pop_black,172,123,-49,143
0252,pop_hisp,1749,1485,-264,1591
0252,pop_nhpi,0,5,5,3
0252,pop_other,3,2,-1,2
0252,pop_two,45,65,20,57
0252,pop_white,539,297,-242,394
0252,vap,1665,1438,-227,1529
0252,vap_aian,30,8,-22,17
0252,vap_asian,8,88,80,56
0252,vap_black,96,86,-10,90
0252,vap_hisp,1044,941,-103,982
0252,vap_nhpi,0,5,5,3
0252,vap_other,0,1,1,1
0252,vap_two,19,39,20,31
0252,vap_white,468,270,-198,349
0253,pop,1108,890,-218,977
0253,pop_aian,12,6,-6,8
0253,pop_asian,13,42,29,30
0253,pop_black,24,9,-15,15
0253,pop_hisp,822,692,-130,744
0253,pop_nhpi,0,0,0,0
0253,pop_other,0,8,8,5
0253,pop_two,13,17,4,15
0253,pop_white,224,116,-108,159
0253,vap,730,604,-126,654
0253,vap_aian,9,3,-6,5
0253,vap_asian,9,21,12,16
0253,vap_black,16,9,-7,12
0253,vap_hisp,486,456,-30,468
0253,vap_nhpi,0,0,0,0
0253,vap_other,0,5,5,3
0253,vap_two,9,8,-1,8
0253,vap_white,201,102,-99,142
0254,pop,1325,1178,-147,1237
0254,pop_aian,20,2,-18,9
0254,pop_asian,30,62,32,49
0254,pop_black,98,100,2,99
0254,pop_hisp,970,864,-106,906
0254,pop_nhpi,0,0,0,0
0254,pop_other,4,3,-1,3
0254,pop_two,32,33,1,33
0254,pop_white,171,114,-57,137
0254,vap,807,776,-31,788
0254,vap_aian,14,2,-12,7
0254,vap_asian,11,40,29,28
0254,vap_black,65,53,-12,58
0254,vap_hisp,560,575,15,569
0254,vap_nhpi,0,0,0,0
0254,vap_other,4,1,-3,2
0254,vap_two,15,19,4,17
0254,vap_white,138,86,-52,107
0255,pop,1407,1442,35,1428
0255,pop_aian,25,8,-17,15
0255,pop_asian,24,66,42,49
0255,pop_black,94,166,72,137
0255,pop_hisp,1033,997,-36,1011
0255,pop_nhpi,0,1,1,1
0255,pop_other,2,3,1,3
0255,pop_two,26,37,11,33
0255,pop_white,203,164,-39,180
0255,vap,911,928,17,921
0255,vap_aian,19,7,-12,12
0255,vap_asian,18,34,16,28
0255,vap_black,60,113,53,92
0255,vap_hisp,634,611,-23,620
0255,vap_nhpi,0,1,1,1
0255,vap_other,1,1,0,1
0255,vap_two,5,19,14,13
0255,vap_white,174,142,-32,155
0256,pop,1946,1894,-52,1915
0256,pop_aian,22,14,-8,17
0256,pop_asian,19,52,33,39
0256,pop_black,126,98,-28,109
0256,pop_hisp,1465,1517,52,1496
0256,pop_nhpi,0,1,1,1
0256,pop_other,2,1,-1,1
0256,pop_two,35,35,0,35
0256,pop_white,277,176,-101,216
0256,vap,1222,1285,63,1260
0256,vap_aian,12,4,-8,7
0256,vap_asian,9,36,27,25
0256,vap_black,71,64,-7,67
0256,vap_hisp,869,1001,132,948
0256,vap_nhpi,0,1,1,1
0256,vap_other,2,1,-1,1
0256,vap_two,16,22,6,20
0256,vap_white,243,156,-87,191
0257,pop,3327,3178,-149,3238
0257,pop_aian,32,17,-15,23
0257,pop_asian,61,104,43,87
0257,pop_black,238,222,-16,228
0257,pop_hisp,2428,2405,-23,2414
0257,pop_nhpi,0,2,2,1
0257,pop_other,0,14,14,8
0257,pop_two,58,52,-6,54
0257,pop_white,510,362,-148,421
0257,vap,2076,2089,13,2084
0257,vap_aian,26,11,-15,17
0257,vap_asian,43,61,18,54
0257,vap_black,128,139,11,135
0257,vap_hisp,1427,1518,91,1482
0257,vap_nhpi,0,2,2,1
0257,vap_other,0,9,9,5
0257,vap_two,22,32,10,28
0257,vap_white,430,317,-113,362
0258,pop,3119,3083,-36,3097
0258,pop_aian,39,17,-22,26
0258,pop_asian,57,31,-26,41
0258,pop_black,100,74,-26,84
0258,pop_hisp,2135,2440,305,2318
0258,pop_nhpi,0,1,1,1
0258,pop_other,1,5,4,3
0258,pop_two,41,68,27,57
0258,pop_white,746,447,-299,567
0258,vap,2005,2024,19,2016
0258,vap_aian,27,12,-15,18
0258,vap_asian,45,20,-25,30
0258,vap_black,65,60,-5,62
0258,vap_hisp,1223,1501,278,1390
0258,vap_nhpi,0,0,0,0
0258,vap_other,1,4,3,3
0258,vap_two,17,40,23,31
0258,vap_white,627,387,-240,483
0259,pop,1912,1863,-49,1883
0259,pop_aian,22,7,-15,13
0259,pop_asian,10,16,6,14
0259,pop_black,68,60,-8,63
0259,pop_hisp,1271,1435,164,1369
0259,pop_nhpi,0,0,0,0
0259,pop_other,1,4,3,3
0259,pop_two,31,25,-6,27
0259,pop_white,509,316,-193,393
0259,vap,1273,1304,31,1292
0259,vap_aian,17,3,-14,9
0259,vap_asian,8,10,2,9
0259,vap_black,38,40,2,39
0259,vap_hisp,748,926,178,855
0259,vap_nhpi,0,0,0,0
0259,vap_other,1,4,3,3
0259,vap_two,15,16,1,16
0259,vap_white,446,305,-141,361
0260,pop,992,1167,175,1097
0260,pop_aian,8,3,-5,5
0260,pop_asian,44,98,54,76
0260,pop_black,55,109,54,87
0260,pop_hisp,394,576,182,503
0260,pop_nhpi,0,0,0,0
0260,pop_other,1,2,1,2
0260,pop_two,19,58,39,42
0260,pop_white,471,321,-150,381
0260,vap,730,844,114,798
0260,vap_aian,7,3,-4,5
0260,vap_asian,32,63,31,51
0260,vap_black,39,83,44,65
0260,vap_hisp,233,372,139,316
0260,vap_nhpi,0,0,0,0
0260,vap_other,1,2,1,2
0260,vap_two,11,36,25,26
0260,vap_white,407,285,-122,334
0261,pop,1010,1073,63,1048
0261,pop_aian,6,11,5,9
0261,pop_asian,16,87,71,59
0261,pop_black,46,54,8,51
0261,pop_hisp,213,354,141,298
0261,pop_nhpi,0,0,0,0
0261,pop_other,2,9,7,6
0261,pop_two,18,31,13,26
0261,pop_white,709,527,-182,600
0261,vap,775,822,47,803
0261,vap_aian,4,5,1,5
0261,vap_asian,14,56,42,39
0261,vap_black,30,40,10,36
0261,vap_hisp,137,229,92,192
0261,vap_nhpi,0,0,0,0
0261,vap_other,2,8,6,6
0261,vap_two,10,20,10,16
0261,vap_white,578,464,-114,510
0262,pop,2004,2030,26,2020
0262,pop_aian,9,15,6,13
0262,pop_asian,54,61,7,58
0262,pop_black,32,69,37,54
0262,pop_hisp,315,674,359,530
0262,pop_nhpi,0,0,0,0
0262,pop_other,1,9,8,6
0262,pop_two,25,62,37,47
0262,pop_white,1568,1140,-428,1311
0262,vap,1523,1524,1,1524
0262,vap_aian,8,11,3,10
0262,vap_asian,37,41,4,39
0262,vap_black,21,48,27,37
0262,vap_hisp,186,403,217,316
0262,vap_nhpi,0,0,0,0
0262,vap_other,1,9,8,6
0262,vap_two,11,37,26,27
0262,vap_white,1259,975,-284,1089
0263,pop,1402,1478,76,1448
0263,pop_aian,15,5,-10,9
0263,pop_asian,23,48,25,38
0263,pop_black,112,117,5,115
0263,pop_hisp,372,702,330,570
0263,pop_nhpi,0,0,0,0
0263,pop_other,0,0,0,0
0263,pop_two,32,30,-2,31
0263,pop_white,848,576,-272,685
0263,vap,1061,1111,50,1091
0263,vap_aian,12,4,-8,7
0263,vap_asian,20,33,13,28
0263,vap_black,87,83,-4,85
0263,vap_hisp,214,463,249,363
0263,vap_nhpi,0,0,0,0
0263,vap_other,0,0,0,0
0263,vap_two,13,18,5,16
0263,vap_white,715,510,-205,592
0264,pop,2129,2288,159,2224
0264,pop_aian,11,14,3,13
0264,pop_asian,40,58,18,51
0264,pop_black,68,102,34,88
0264,pop_hisp,339,654,315,528
0264,pop_nhpi,0,6,6,4
0264,pop_other,6,11,5,9
0264,pop_two,37,119,82,86
0264,pop_white,1628,1324,-304,1446
0264,vap,1691,1769,78,1738
0264,vap_aian,7,9,2,8
0264,vap_asian,29,42,13,37
0264,vap_black,51,80,29,68
0264,vap_hisp,222,417,195,339
0264,vap_nhpi,0,5,5,3
0264,vap_other,1,8,7,5
0264,vap_two,13,69,56,47
0264,vap_white,1368,1139,-229,1231
0265,pop,1222,1304,82,1271
0265,pop_aian,7,13,6,11
0265,pop_asian,5,31,26,21
0265,pop_black,27,27,0,27
0265,pop_hisp,160,355,195,277
0265,pop_nhpi,0,0,0,0
0265,pop_other,1,7,6,5
0265,pop_two,19,43,24,33
0265,pop_white,1003,828,-175,898
0265,vap,958,972,14,966
0265,vap_aian,7,12,5,10
0265,vap_asian,5,18,13,13
0265,vap_black,11,15,4,13
0265,vap_hisp,83,200,117,153
0265,vap_nhpi,0,0,0,0
0265,vap_other,1,6,5,4
0265,vap_two,13,23,10,19
0265,vap_white,838,698,-140,754
0266,pop,1322,1460,138,1405
0266,pop_aian,6,11,5,9
0266,pop_asian,22,53,31,41
0266,pop_black,15,56,41,40
0266,pop_hisp,157,341,184,267
0266,pop_nhpi,1,0,-1,0
0266,pop_other,0,2,2,1
0266,pop_two,28,61,33,48
0266,pop_white,1093,936,-157,999
0266,vap,1058,1153,95,1115
0266,vap_aian,6,8,2,7
0266,vap_asian,15,40,25,30
0266,vap_black,11,45,34,31
0266,vap_hisp,97,220,123,171
0266,vap_nhpi,1,0,-1,0
0266,vap_other,0,2,2,1
0266,vap_two,15,35,20,27
0266,vap_white,913,803,-110,847
0267,pop,1070,1209,139,1153
0267,pop_aian,11,9,-2,10
0267,pop_asian,9,45,36,31
0267,pop_black,17,36,19,28
0267,pop_hisp,107,325,218,238
0267,pop_nhpi,0,0,0,0
0267,pop_other,1,4,3,3
0267,pop_two,19,39,20,31
0267,pop_white,906,751,-155,813
0267,vap,874,943,69,915
0267,vap_aian,7,7,0,7
0267,vap_asian,7,26,19,18
0267,vap_black,8,25,17,18
0267,vap_hisp,63,196,133,143
0267,vap_nhpi,0,0,0,0
0267,vap_other,0,3,3,2
0267,vap_two,5,25,20,17
0267,vap_white,784,661,-123,710
0268,pop,2810,2927,117,2880
0268,pop_aian,32,21,-11,25
0268,pop_asian,45,97,52,76
0268,pop_black,89,112,23,103
0268,pop_hisp,393,843,450,663
0268,pop_nhpi,0,1,1,1
0268,pop_other,6,9,3,8
0268,pop_two,60,104,44,86
0268,pop_white,2185,1740,-445,1918
0268,vap,2220,2316,96,2278
0268,vap_aian,21,19,-2,20
0268,vap_asian,33,70,37,55
0268,vap_black,53,79,26,69
0268,vap_hisp,250,534,284,420
0268,vap_nhpi,0,1,1,1
0268,vap_other,5,6,1,6
0268,vap_two,21,69,48,50
0268,vap_white,1837,1538,-299,1658
0269,pop,1738,1736,-2,1737
0269,pop_aian,10,8,-2,9
0269,pop_asian,31,82,51,62
0269,pop_black,62,125,63,100
0269,pop_hisp,201,332,131,280
0269,pop_nhpi,0,1,1,1
0269,pop_other,2,4,2,3
0269,pop_two,21,61,40,45
0269,pop_white,1411,1123,-288,1238
0269,vap,1449,1398,-51,1418
0269,vap_aian,6,8,2,7
0269,vap_asian,24,51,27,40
0269,vap_black,44,86,42,69
0269,vap_hisp,123,223,100,183
0269,vap_nhpi,0,0,0,0
0269,vap_other,1,1,0,1
0269,vap_two,11,39,28,28
0269,vap_white,1240,990,-250,1090
0270,pop,1537,1546,9,1542
0270,pop_aian,12,10,-2,11
0270,pop_asian,26,72,46,54
0270,pop_black,30,40,10,36
0270,pop_hisp,111,317,206,235
0270,pop_nhpi,0,0,0,0
0270,pop_other,1,3,2,2
0270,pop_two,21,85,64,59
0270,pop_white,1336,1019,-317,1146
0270,vap,1197,1205,8,1202
0270,vap_aian,8,7,-1,7
0270,vap_asian,23,49,26,39
0270,vap_black,15,29,14,23
0270,vap_hisp,67,181,114,135
0270,vap_nhpi,0,0,0,0
0270,vap_other,1,2,1,2
0270,vap_two,11,48,37,33
0270,vap_white,1072,889,-183,962
0271,pop,2677,2679,2,2678
0271,pop_aian,11,18,7,15
0271,pop_asian,56,92,36,78
0271,pop_black,65,155,90,119
0271,pop_hisp,279,395,116,349
0271,pop_nhpi,0,0,0,0
0271,pop_other,2,21,19,13
0271,pop_two,28,116,88,81
0271,pop_white,2236,1882,-354,2024
0271,vap,2190,2238,48,2219
0271,vap_aian,7,14,7,11
0271,vap_asian,43,69,26,59
0271,vap_black,54,122,68,95
0271,vap_hisp,159,249,90,213
0271,vap_nhpi,0,0,0,0
0271,vap_other,1,21,20,13
0271,vap_two,11,78,67,51
0271,vap_white,1915,1685,-230,1777
0272,pop,2019,1883,-136,1937
0272,pop_aian,20,8,-12,13
0272,pop_asian,18,42,24,32
0272,pop_black,69,98,29,86
0272,pop_hisp,240,289,49,269
0272,pop_nhpi,4,0,-4,2
0272,pop_other,5,2,-3,3
0272,pop_two,43,95,52,74
0272,pop_white,1620,1349,-271,1457
0272,vap,1455,1501,46,1483
0272,vap_aian,13,7,-6,9
0272,vap_asian,9,36,27,25
0272,vap_black,42,70,28,59
0272,vap_hisp,133,183,50,163
0272,vap_nhpi,2,0,-2,1
0272,vap_other,1,2,1,2
0272,vap_two,11,39,28,28
0272,vap_white,1244,1164,-80,1196
0273,pop,1199,1180,-19,1188
0273,pop_aian,9,5,-4,7
0273,pop_asian,25,22,-3,23
0273,pop_black,15,52,37,37
0273,pop_hisp,100,237,137,182
0273,pop_nhpi,0,0,0,0
0273,pop_other,0,10,10,6
0273,pop_two,27,52,25,42
0273,pop_white,1023,802,-221,890
0273,vap,912,852,-60,876
0273,vap_aian,9,2,-7,5
0273,vap_asian,22,19,-3,20
0273,vap_black,7,29,22,20
0273,vap_hisp,49,120,71,92
0273,vap_nhpi,0,0,0,0
0273,vap_other,0,8,8,5
0273,vap_two,11,28,17,21
0273,vap_white,814,646,-168,713
0274,pop,1204,1238,34,1224
0274,pop_aian,11,13,2,12
0274,pop_asian,15,34,19,26
0274,pop_black,32,58,26,48
0274,pop_hisp,146,273,127,222
0274,pop_nhpi,0,0,0,0
0274,pop_other,4,5,1,5
0274,pop_two,31,48,17,41
0274,pop_white,965,807,-158,870
0274,vap,901,948,47,929
0274,vap_aian,8,11,3,10
0274,vap_asian,11,29,18,22
0274,vap_black,23,42,19,34
0274,vap_hisp,87,173,86,139
0274,vap_nhpi,0,0,0,0
0274,vap_other,2,3,1,3
0274,vap_two,7,20,13,15
0274,vap_white,763,670,-93,707
0275,pop,2969,3022,53,3001
0275,pop_aian,34,18,-16,24
0275,pop_asian,94,179,85,145
0275,pop_black,142,206,64,180
0275,pop_hisp,442,625,183,552
0275,pop_nhpi,0,0,0,0
0275,pop_other,5,10,5,8
0275,pop_two,90,209,119,161
0275,pop_white,2162,1775,-387,1930
0275,vap,2249,2302,53,2281
0275,vap_aian,24,18,-6,20
0275,vap_asian,76,126,50,106
0275,vap_black,82,143,61,119
0275,vap_hisp,259,385,126,335
0275,vap_nhpi,0,0,0,0
0275,vap_other,3,4,1,4
0275,vap_two,47,115,68,88
0275,vap_white,1758,1511,-247,1610
0276,pop,2097,2299,202,2218
0276,pop_aian,10,8,-2,9
0276,pop_asian,79,206,127,155
0276,pop_black,10,74,64,48
0276,pop_hisp,185,378,193,301
0276,pop_nhpi,2,1,-1,1
0276,pop_other,7,10,3,9
0276,pop_two,29,86,57,63
0276,pop_white,1775,1536,-239,1632
0276,vap,1666,1815,149,1755
0276,vap_aian,9,8,-1,8
0276,vap_asian,57,124,67,97
0276,vap_black,9,56,47,37
0276,vap_hisp,112,247,135,193
0276,vap_nhpi,2,1,-1,1
0276,vap_other,3,7,4,5
0276,vap_two,15,48,33,35
0276,vap_white,1459,1324,-135,1378
0277,pop,2531,2602,71,2574
0277,pop_aian,24,15,-9,19
0277,pop_asian,36,109,73,80
0277,pop_black,68,152,84,118
0277,pop_hisp,345,649,304,527
0277,pop_nhpi,0,1,1,1
0277,pop_other,2,8,6,6
0277,pop_two,63,92,29,80
0277,pop_white,1993,1576,-417,1743
0277,vap,2030,2123,93,2086
0277,vap_aian,14,13,-1,13
0277,vap_asian,31,76,45,58
0277,vap_black,50,110,60,86
0277,vap_hisp,224,461,237,366
0277,vap_nhpi,0,1,1,1
0277,vap_other,0,8,8,5
0277,vap_two,32,61,29,49
0277,vap_white,1679,1393,-286,1507
0278,pop,1483,1548,65,1522
0278,pop_aian,16,16,0,16
0278,pop_asian,22,66,44,48
0278,pop_black,68,78,10,74
0278,pop_hisp,251,390,139,334
0278,pop_nhpi,0,0,0,0
0278,pop_other,1,2,1,2
0278,pop_two,20,55,35,41
0278,pop_white,1105,941,-164,1007
0278,vap,1159,1157,-2,1158
0278,vap_aian,15,16,1,16
0278,vap_asian,17,45,28,34
0278,vap_black,39,57,18,50
0278,vap_hisp,153,242,89,206
0278,vap_nhpi,0,0,0,0
0278,vap_other,0,1,1,1
0278,vap_two,12,24,12,19
0278,vap_white,923,772,-151,832
0279,pop,2127,2213,86,2179
0279,pop_aian,16,13,-3,14
0279,pop_asian,43,88,45,70
0279,pop_black,35,82,47,63
0279,pop_hisp,323,718,395,560
0279,pop_nhpi,0,0,0,0
0279,pop_other,0,13,13,8
0279,pop_two,22,96,74,66
0279,pop_white,1688,1203,-485,1397
0279,vap,1670,1638,-32,1651
0279,vap_aian,13,9,-4,11
0279,vap_asian,34,56,22,47
0279,vap_black,23,63,40,47
0279,vap_hisp,185,423,238,328
0279,vap_nhpi,0,0,0,0
0279,vap_other,0,6,6,4
0279,vap_two,12,48,36,34
0279,vap_white,1403,1033,-370,1181
0280,pop,3586,3685,99,3645
0280,pop_aian,23,18,-5,20
0280,pop_asian,152,233,81,201
0280,pop_black,245,338,93,301
0280,pop_hisp,780,1278,498,1079
0280,pop_nhpi,4,1,-3,2
0280,pop_other,0,12,12,7
0280,pop_two,91,151,60,127
0280,pop_white,2291,1654,-637,1909
0280,vap,2829,2839,10,2835
0280,vap_aian,20,18,-2,19
0280,vap_asian,117,144,27,133
0280,vap_black,171,267,96,229
0280,vap_hisp,513,876,363,731
0280,vap_nhpi,3,1,-2,2
0280,vap_other,0,10,10,6
0280,vap_two,34,90,56,68
0280,vap_white,1971,1433,-538,1648
0281,pop,1646,1759,113,1714
0281,pop_aian,14,18,4,16
0281,pop_asian,92,298,206,216
0281,pop_black,76,65,-11,69
0281,pop_hisp,528,719,191,643
0281,pop_nhpi,0,0,0,0
0281,pop_other,2,11,9,7
0281,pop_two,34,70,36,56
0281,pop_white,900,578,-322,707
0281,vap,1243,1224,-19,1232
0281,vap_aian,12,18,6,16
0281,vap_asian,56,161,105,119
0281,vap_black,51,45,-6,47
0281,vap_hisp,332,449,117,402
0281,vap_nhpi,0,0,0,0
0281,vap_other,0,5,5,3
0281,vap_two,18,43,25,33
0281,vap_white,774,503,-271,611
0282,pop,1293,1363,70,1335
0282,pop_aian,12,6,-6,8
0282,pop_asian,160,301,141,245
0282,pop_black,169,289,120,241
0282,pop_hisp,429,380,-49,400
0282,pop_nhpi,0,0,0,0
0282,pop_other,0,10,10,6
0282,pop_two,37,35,-2,36
0282,pop_white,486,342,-144,400
0282,vap,989,1023,34,1009
0282,vap_aian,11,6,-5,8
0282,vap_asian,103,181,78,150
0282,vap_black,125,222,97,183
0282,vap_hisp,281,281,0,281
0282,vap_nhpi,0,0,0,0
0282,vap_other,0,4,4,2
0282,vap_two,22,20,-2,21
0282,vap_white,447,309,-138,364
0283,pop,1959,2191,232,2098
0283,pop_aian,13,6,-7,9
0283,pop_asian,71,350,279,238
0283,pop_black,119,191,72,162
0283,pop_hisp,835,1044,209,960
0283,pop_nhpi,0,0,0,0
0283,pop_other,8,13,5,11
0283,pop_two,36,46,10,42
0283,pop_white,878,541,-337,676
0283,vap,1414,1497,83,1464
0283,vap_aian,10,6,-4,8
0283,vap_asian,60,219,159,155
0283,vap_black,72,120,48,101
0283,vap_hisp,489,669,180,597
0283,vap_nhpi,0,0,0,0
0283,vap_other,8,13,5,11
0283,vap_two,20,18,-2,19
0283,vap_white,754,452,-302,573
0284,pop,1732,1912,180,1840
0284,pop_aian,22,9,-13,14
0284,pop_asian,19,125,106,83
0284,pop_black,200,202,2,201
0284,pop_hisp,899,1207,308,1084
0284,pop_nhpi,0,0,0,0
0284,pop_other,0,5,5,3
0284,pop_two,27,23,-4,25
0284,pop_white,565,341,-224,431
0284,vap,1231,1354,123,1305
0284,vap_aian,11,6,-5,8
0284,vap_asian,18,78,60,54
0284,vap_black,117,148,31,136
0284,vap_hisp,557,800,243,703
0284,vap_nhpi,0,0,0,0
0284,vap_other,0,0,0,0
0284,vap_two,12,13,1,13
0284,vap_white,515,309,-206,391
0285,pop,612,613,1,613
0285,pop_aian,6,4,-2,5
0285,pop_asian,0,22,22,13
0285,pop_black,28,7,-21,15
0285,pop_hisp,423,453,30,441
0285,pop_nhpi,2,0,-2,1
0285,pop_other,0,3,3,2
0285,pop_two,6,13,7,10
0285,pop_white,147,111,-36,125
0285,vap,385,404,19,396
0285,vap_aian,3,4,1,4
0285,vap_asian,0,14,14,8
0285,vap_black,15,7,-8,10
0285,vap_hisp,243,272,29,260
0285,vap_nhpi,1,0,-1,0
0285,vap_other,0,3,3,2
0285,vap_two,2,4,2,3
0285,vap_white,121,100,-21,108
0286,pop,1341,1484,143,1427
0286,pop_aian,2,0,-2,1
0286,pop_asian,14,99,85,65
0286,pop_black,50,41,-9,45
0286,pop_hisp,548,878,330,746
0286,pop_nhpi,1,0,-1,0
0286,pop_other,2,7,5,5
0286,pop_two,15,39,24,29
0286,pop_white,709,420,-289,536
0286,vap,1025,1082,57,1059
0286,vap_aian,1,0,-1,0
0286,vap_asian,11,65,54,43
0286,vap_black,38,35,-3,36
0286,vap_hisp,331,560,229,468
0286,vap_nhpi,0,0,0,0
0286,vap_other,1,7,6,5
0286,vap_two,10,27,17,20
0286,vap_white,633,388,-245,486
0287,pop,1053,1061,8,1058
0287,pop_aian,14,6,-8,9
0287,pop_asian,12,41,29,29
0287,pop_black,16,35,19,27
0287,pop_hisp,408,573,165,507
0287,pop_nhpi,0,0,0,0
0287,pop_other,4,7,3,6
0287,pop_two,15,28,13,23
0287,pop_white,584,371,-213,456
0287,vap,776,808,32,795
0287,vap_aian,13,5,-8,8
0287,vap_asian,9,19,10,15
0287,vap_black,8,28,20,20
0287,vap_hisp,252,400,148,341
0287,vap_nhpi,0,0,0,0
0287,vap_other,1,1,0,1
0287,vap_two,9,22,13,17
0287,vap_white,484,333,-151,393
0288,pop,2316,2583,267,2476
0288,pop_aian,23,23,0,23
0288,pop_asian,20,189,169,121
0288,pop_black,51,58,7,55
0288,pop_hisp,808,1173,365,1027
0288,pop_nhpi,0,0,0,0
0288,pop_other,1,2,1,2
0288,pop_two,35,56,21,48
0288,pop_white,1378,1082,-296,1200
0288,vap,1691,1896,205,1814
0288,vap_aian,12,19,7,16
0288,vap_asian,15,111,96,73
0288,vap_black,33,43,10,39
0288,vap_hisp,496,795,299,675
0288,vap_nhpi,0,0,0,0
0288,vap_other,1,0,-1,0
0288,vap_two,16,31,15,25
0288,vap_white,1118,897,-221,985
0289,pop,1867,2090,223,2001
0289,pop_aian,8,10,2,9
0289,pop_asian,39,208,169,140
0289,pop_black,39,43,4,41
0289,pop_hisp,960,1284,324,1154
0289,pop_nhpi,2,0,-2,1
0289,pop_other,0,3,3,2
0289,pop_two,25,35,10,31
0289,pop_white,794,507,-287,622
0289,vap,1300,1434,134,1380
0289,vap_aian,8,10,2,9
0289,vap_asian,23,119,96,81
0289,vap_black,24,27,3,26
0289,vap_hisp,575,829,254,727
0289,vap_nhpi,2,0,-2,1
0289,vap_other,0,3,3,2
0289,vap_two,9,18,9,14
0289,vap_white,659,428,-231,520
0290,pop,2255,2242,-13,2247
0290,pop_aian,25,17,-8,20
0290,pop_asian,38,103,65,77
0290,pop_black,60,95,35,81
0290,pop_hisp,1548,1581,33,1568
0290,pop_nhpi,0,1,1,1
0290,pop_other,1,9,8,6
0290,pop_two,34,44,10,40
0290,pop_white,549,392,-157,455
0290,vap,1482,1556,74,1526
0290,vap_aian,22,16,-6,18
0290,vap_asian,29,63,34,49
0290,vap_black,34,63,29,51
0290,vap_hisp,921,1050,129,998
0290,vap_nhpi,0,1,1,1
0290,vap_other,1,6,5,4
0290,vap_two,10,21,11,17
0290,vap_white,465,336,-129,388
0291,pop,1898,1977,79,1945
0291,pop_aian,16,14,-2,15
0291,pop_asian,15,94,79,62
0291,pop_black,38,34,-4,36
0291,pop_hisp,1226,1412,186,1338
0291,pop_nhpi,2,1,-1,1
0291,pop_other,3,4,1,4
0291,pop_two,14,26,12,21
0291,pop_white,584,392,-192,469
0291,vap,1284,1371,87,1336
0291,vap_aian,11,13,2,12
0291,vap_asian,10,55,45,37
0291,vap_black,24,22,-2,23
0291,vap_hisp,726,916,190,840
0291,vap_nhpi,2,0,-2,1
0291,vap_other,1,4,3,3
0291,vap_two,8,11,3,10
0291,vap_white,502,350,-152,411
0292,pop,1485,1589,104,1547
0292,pop_aian,13,14,1,14
0292,pop_asian,9,116,107,73
0292,pop_black,13,41,28,30
0292,pop_hisp,602,742,140,686
0292,pop_nhpi,0,0,0,0
0292,pop_other,2,10,8,7
0292,pop_two,21,44,23,35
0292,pop_white,825,622,-203,703
0292,vap,1087,1125,38,1110
0292,vap_aian,11,9,-2,10
0292,vap_asian,6,58,52,37
0292,vap_black,10,21,11,17
0292,vap_hisp,353,477,124,427
0292,vap_nhpi,0,0,0,0
0292,vap_other,2,4,2,3
0292,vap_two,13,20,7,17
0292,vap_white,692,536,-156,598
0293,pop,1361,1344,-17,1351
0293,pop_aian,14,5,-9,9
0293,pop_asian,14,19,5,17
0293,pop_black,16,25,9,21
0293,pop_hisp,200,289,89,253
0293,pop_nhpi,0,2,2,1
0293,pop_other,3,5,2,4
0293,pop_two,14,69,55,47
0293,pop_white,1100,930,-170,998
0293,vap,1073,1058,-15,1064
0293,vap_aian,10,5,-5,7
0293,vap_asian,9,15,6,13
0293,vap_black,9,23,14,17
0293,vap_hisp,128,169,41,153
0293,vap_nhpi,0,2,2,1
0293,vap_other,3,5,2,4
0293,vap_two,11,40,29,28
0293,vap_white,903,799,-104,841
0294,pop,1089,973,-116,1019
0294,pop_aian,14,11,-3,12
0294,pop_asian,19,15,-4,17
0294,pop_black,13,8,-5,10
0294,pop_hisp,174,156,-18,163
0294,pop_nhpi,0,0,0,0
0294,pop_other,0,2,2,1
0294,pop_two,25,39,14,33
0294,pop_white,844,742,-102,783
0294,vap,840,796,-44,814
0294,vap_aian,10,10,0,10
0294,vap_asian,13,15,2,14
0294,vap_black,9,5,-4,7
0294,vap_hisp,100,105,5,103
0294,vap_nhpi,0,0,0,0
0294,vap_other,0,1,1,1
0294,vap_two,6,28,22,19
0294,vap_white,702,632,-70,660
0295,pop,1268,1240,-28,1251
0295,pop_aian,32,5,-27,16
0295,pop_asian,13,16,3,15
0295,pop_black,17,33,16,27
0295,pop_hisp,188,267,79,235
0295,pop_nhpi,1,0,-1,0
0295,pop_other,1,3,2,2
0295,pop_two,30,80,50,60
0295,pop_white,986,836,-150,896
0295,vap,1029,1027,-2,1028
0295,vap_aian,21,4,-17,11
0295,vap_asian,7,11,4,9
0295,vap_black,13,22,9,18
0295,vap_hisp,124,183,59,159
0295,vap_nhpi,1,0,-1,0
0295,vap_other,0,1,1,1
0295,vap_two,15,45,30,33
0295,vap_white,848,761,-87,796
0296,pop,1512,1481,-31,1493
0296,pop_aian,11,10,-1,10
0296,pop_asian,24,16,-8,19
0296,pop_black,14,39,25,29
0296,pop_hisp,152,185,33,172
0296,pop_nhpi,2,0,-2,1
0296,pop_other,0,8,8,5
0296,pop_two,23,64,41,48
0296,pop_white,1286,1159,-127,1210
0296,vap,1241,1221,-20,1229
0296,vap_aian,9,10,1,10
0296,vap_asian,17,11,-6,13
0296,vap_black,9,30,21,22
0296,vap_hisp,93,110,17,103
0296,vap_nhpi,2,0,-2,1
0296,vap_other,0,8,8,5
0296,vap_two,13,42,29,30
0296,vap_white,1098,1010,-88,1045
0297,pop,1283,1182,-101,1222
0297,pop_aian,20,5,-15,11
0297,pop_asian,18,17,-1,17
0297,pop_black,38,29,-9,33
0297,pop_hisp,155,150,-5,152
0297,pop_nhpi,0,1,1,1
0297,pop_other,1,7,6,5
0297,pop_two,31,46,15,40
0297,pop_white,1020,927,-93,964
0297,vap,1064,987,-77,1018
0297,vap_aian,16,5,-11,9
0297,vap_asian,11,16,5,14
0297,vap_black,24,20,-4,22
0297,vap_hisp,102,110,8,107
0297,vap_nhpi,0,1,1,1
0297,vap_other,0,7,7,4
0297,vap_two,17,27,10,23
0297,vap_white,894,801,-93,838
0298,pop,1117,1135,18,1128
0298,pop_aian,8,1,-7,4
0298,pop_asian,3,12,9,8
0298,pop_black,25,26,1,26
0298,pop_hisp,123,144,21,136
0298,pop_nhpi,0,0,0,0
0298,pop_other,1,10,9,6
0298,pop_two,13,29,16,23
0298,pop_white,944,913,-31,925
0298,vap,931,924,-7,927
0298,vap_aian,7,1,-6,3
0298,vap_asian,2,10,8,7
0298,vap_black,21,21,0,21
0298,vap_hisp,85,94,9,90
0298,vap_nhpi,0,0,0,0
0298,vap_other,0,6,6,4
0298,vap_two,9,21,12,16
0298,vap_white,807,771,-36,785
0299,pop,1384,1248,-136,1302
0299,pop_aian,22,4,-18,11
0299,pop_asian,27,17,-10,21
0299,pop_black,10,18,8,15
0299,pop_hisp,109,111,2,110
0299,pop_nhpi,0,1,1,1
0299,pop_other,7,5,-2,6
0299,pop_two,39,76,37,61
0299,pop_white,1170,1016,-154,1078
0299,vap,1155,1070,-85,1104
0299,vap_aian,17,4,-13,9
0299,vap_asian,22,16,-6,18
0299,vap_black,6,15,9,11
0299,vap_hisp,69,72,3,71
0299,vap_nhpi,0,1,1,1
0299,vap_other,2,5,3,4
0299,vap_two,18,47,29,35
0299,vap_white,1021,910,-111,954
0300,pop,1619,1672,53,1651
0300,pop_aian,7,8,1,8
0300,pop_asian,13,26,13,21
0300,pop_black,15,18,3,17
0300,pop_hisp,99,169,70,141
0300,pop_nhpi,0,0,0,0
0300,pop_other,1,10,9,6
0300,pop_two,11,65,54,43
0300,pop_white,1473,1376,-97,1415
0300,vap,1382,1410,28,1399
0300,vap_aian,7,7,0,7
0300,vap_asian,10,23,13,18
0300,vap_black,9,13,4,11
0300,vap_hisp,66,126,60,102
0300,vap_nhpi,0,0,0,0
0300,vap_other,0,10,10,6
0300,vap_two,6,38,32,25
0300,vap_white,1284,1193,-91,1229
0301,pop,1900,1827,-73,1856
0301,pop_aian,12,5,-7,8
0301,pop_asian,17,15,-2,16
0301,pop_black,42,66,24,56
0301,pop_hisp,211,261,50,241
0301,pop_nhpi,0,0,0,0
0301,pop_other,0,6,6,4
0301,pop_two,32,104,72,75
0301,pop_white,1586,1370,-216,1456
0301,vap,1510,1492,-18,1499
0301,vap_aian,8,5,-3,6
0301,vap_asian,7,12,5,10
0301,vap_black,29,40,11,36
0301,vap_hisp,121,169,48,150
0301,vap_nhpi,0,0,0,0
0301,vap_other,0,6,6,4
0301,vap_two,17,70,53,49
0301,vap_white,1328,1190,-138,1245
0302,pop,1358,1369,11,1365
0302,pop_aian,8,8,0,8
0302,pop_asian,19,21,2,20
0302,pop_black,37,59,22,50
0302,pop_hisp,188,261,73,232
0302,pop_nhpi,0,1,1,1
0302,pop_other,0,2,2,1
0302,pop_two,29,72,43,55
0302,pop_white,1077,945,-132,998
0302,vap,1035,1087,52,1066
0302,vap_aian,6,1,-5,3
0302,vap_asian,9,14,5,12
0302,vap_black,20,40,20,32
0302,vap_hisp,106,170,64,144
0302,vap_nhpi,0,1,1,1
0302,vap_other,0,1,1,1
0302,vap_two,12,56,44,38
0302,vap_white,882,804,-78,835
0303,pop,1836,1837,1,1837
0303,pop_aian,6,15,9,11
0303,pop_asian,27,35,8,32
0303,pop_black,17,38,21,30
0303,pop_hisp,178,288,110,244
0303,pop_nhpi,0,0,0,0
0303,pop_other,1,1,0,1
0303,pop_two,23,71,48,52
0303,pop_white,1584,1389,-195,1467
0303,vap,1454,1443,-11,1447
0303,vap_aian,4,14,10,10
0303,vap_asian,21,21,0,21
0303,vap_black,8,22,14,16
0303,vap_hisp,111,185,74,155
0303,vap_nhpi,0,0,0,0
0303,vap_other,1,0,-1,0
0303,vap_two,10,42,32,29
0303,vap_white,1299,1159,-140,1215
0304,pop,1818,1719,-99,1759
0304,pop_aian,13,9,-4,11
0304,pop_asian,90,68,-22,77
0304,pop_black,34,96,62,71
0304,pop_hisp,335,332,-3,333
0304,pop_nhpi,0,1,1,1
0304,pop_other,5,1,-4,3
0304,pop_two,43,98,55,76
0304,pop_white,1298,1114,-184,1188
0304,vap,1441,1381,-60,1405
0304,vap_aian,12,9,-3,10
0304,vap_asian,70,53,-17,60
0304,vap_black,29,63,34,49
0304,vap_hisp,203,206,3,205
0304,vap_nhpi,0,0,0,0
0304,vap_other,4,0,-4,2
0304,vap_two,24,74,50,54
0304,vap_white,1099,976,-123,1025
0305,pop,1621,1726,105,1684
0305,pop_aian,13,8,-5,10
0305,pop_asian,9,19,10,15
0305,pop_black,12,39,27,28
0305,pop_hisp,170,393,223,304
0305,pop_nhpi,1,1,0,1
0305,pop_other,4,8,4,6
0305,pop_two,33,54,21,46
0305,pop_white,1379,1204,-175,1274
0305,vap,1326,1390,64,1364
0305,vap_aian,12,8,-4,10
0305,vap_asian,8,12,4,10
0305,vap_black,9,31,22,22
0305,vap_hisp,102,250,148,191
0305,vap_nhpi,1,0,-1,0
0305,vap_other,0,8,8,5
0305,vap_two,14,25,11,21
0305,vap_white,1180,1056,-124,1106
0306,pop,1537,1759,222,1670
0306,pop_aian,8,12,4,10
0306,pop_asian,26,161,135,107
0306,pop_black,108,97,-11,101
0306,pop_hisp,348,656,308,533
0306,pop_nhpi,0,0,0,0
0306,pop_other,3,3,0,3
0306,pop_two,34,54,20,46
0306,pop_white,1010,776,-234,870
0306,vap,1206,1267,61,1243
0306,vap_aian,4,11,7,8
0306,vap_asian,20,88,68,61
0306,vap_black,64,64,0,64
0306,vap_hisp,210,377,167,310
0306,vap_nhpi,0,0,0,0
0306,vap_other,2,3,1,3
0306,vap_two,17,29,12,24
0306,vap_white,889,695,-194,773
0307,pop,1626,1823,197,1744
0307,pop_aian,20,11,-9,15
0307,pop_asian,31,256,225,166
0307,pop_black,50,63,13,58
0307,pop_hisp,420,636,216,550
0307,pop_nhpi,0,2,2,1
0307,pop_other,1,10,9,6
0307,pop_two,31,55,24,45
0307,pop_white,1073,790,-283,903
0307,vap,1254,1315,61,1291
0307,vap_aian,12,9,-3,10
0307,vap_asian,21,150,129,98
0307,vap_black,30,38,8,35
0307,vap_hisp,265,398,133,345
0307,vap_nhpi,0,2,2,1
0307,vap_other,0,10,10,6
0307,vap_two,14,19,5,17
0307,vap_white,912,689,-223,778
0308,pop,2523,2474,-49,2494
0308,pop_aian,23,14,-9,18
0308,pop_asian,229,389,160,325
0308,pop_black,149,540,391,384
0308,pop_hisp,756,667,-89,703
0308,pop_nhpi,2,2,0,2
0308,pop_other,9,11,2,10
0308,pop_two,72,85,13,80
0308,pop_white,1283,766,-517,973
0308,vap,1868,1757,-111,1801
0308,vap_aian,21,14,-7,17
0308,vap_asian,131,233,102,192
0308,vap_black,114,335,221,247
0308,vap_hisp,487,456,-31,468
0308,vap_nhpi,2,0,-2,1
0308,vap_other,8,11,3,10
0308,vap_two,43,50,7,47
0308,vap_white,1062,658,-404,820
0309,pop,2075,2195,120,2147
0309,pop_aian,15,7,-8,10
0309,pop_asian,120,303,183,230
0309,pop_black,20,33,13,28
0309,pop_hisp,356,477,121,429
0309,pop_nhpi,6,1,-5,3
0309,pop_other,5,9,4,7
0309,pop_two,55,109,54,87
0309,pop_white,1498,1256,-242,1353
0309,vap,1580,1633,53,1612
0309,vap_aian,12,7,-5,9
0309,vap_asian,84,196,112,151
0309,vap_black,14,18,4,16
0309,vap_hisp,227,315,88,280
0309,vap_nhpi,2,0,-2,1
0309,vap_other,3,3,0,3
0309,vap_two,30,52,22,43
0309,vap_white,1208,1042,-166,1108
0310,pop,1432,1532,100,1492
0310,pop_aian,5,2,-3,3
0310,pop_asian,188,546,358,403
0310,pop_black,81,200,119,152
0310,pop_hisp,302,310,8,307
0310,pop_nhpi,0,0,0,0
0310,pop_other,0,7,7,4
0310,pop_two,88,38,-50,58
0310,pop_white,768,429,-339,565
0310,vap,933,940,7,937
0310,vap_aian,3,2,-1,2
0310,vap_asian,104,300,196,222
0310,vap_black,44,101,57,78
0310,vap_hisp,168,185,17,178
0310,vap_nhpi,0,0,0,0
0310,vap_other,0,3,3,2
0310,vap_two,41,22,-19,30
0310,vap_white,573,327,-246,425
0311,pop,1361,1504,143,1447
0311,pop_aian,13,1,-12,6
0311,pop_asian,122,120,-2,121
0311,pop_black,37,61,24,51
0311,pop_hisp,188,270,82,237
0311,pop_nhpi,3,0,-3,1
0311,pop_other,3,6,3,5
0311,pop_two,46,88,42,71
0311,pop_white,949,958,9,954
0311,vap,997,1091,94,1053
0311,vap_aian,9,1,-8,4
0311,vap_asian,78,77,-1,77
0311,vap_black,21,31,10,27
0311,vap_hisp,118,192,74,162
0311,vap_nhpi,3,0,-3,1
0311,vap_other,1,2,1,2
0311,vap_two,19,45,26,35
0311,vap_white,748,743,-5,745
0312,pop,1576,1633,57,1610
0312,pop_aian,7,6,-1,6
0312,pop_asian,51,155,104,113
0312,pop_black,13,40,27,29
0312,pop_hisp,200,391,191,315
0312,pop_nhpi,0,0,0,0
0312,pop_other,0,2,2,1
0312,pop_two,29,49,20,41
0312,pop_white,1276,990,-286,1104
0312,vap,1167,1253,86,1219
0312,vap_aian,4,6,2,5
0312,vap_asian,35,100,65,74
0312,vap_black,10,37,27,26
0312,vap_hisp,124,262,138,207
0312,vap_nhpi,0,0,0,0
0312,vap_other,0,1,1,1
0312,vap_two,9,24,15,18
0312,vap_white,985,823,-162,888
0313,pop,3717,3783,66,3757
0313,pop_aian,20,25,5,23
0313,pop_asian,118,355,237,260
0313,pop_black,100,194,94,156
0313,pop_hisp,533,747,214,661
0313,pop_nhpi,1,0,-1,0
0313,pop_other,8,11,3,10
0313,pop_two,76,129,53,108
0313,pop_white,2861,2322,-539,2538
0313,vap,2871,2914,43,2897
0313,vap_aian,14,23,9,19
0313,vap_asian,78,234,156,172
0313,vap_black,77,145,68,118
0313,vap_hisp,303,468,165,402
0313,vap_nhpi,1,0,-1,0
0313,vap_other,3,11,8,8
0313,vap_two,35,71,36,57
0313,vap_white,2360,1962,-398,2121
0314,pop,1237,1162,-75,1192
0314,pop_aian,12,8,-4,10
0314,pop_asian,20,64,44,46
0314,pop_black,11,43,32,30
0314,pop_hisp,198,248,50,228
0314,pop_nhpi,0,0,0,0
0314,pop_other,0,0,0,0
0314,pop_two,25,54,29,42
0314,pop_white,971,745,-226,835
0314,vap,941,916,-25,926
0314,vap_aian,7,6,-1,6
0314,vap_asian,12,45,33,32
0314,vap_black,8,22,14,16
0314,vap_hisp,131,175,44,157
0314,vap_nhpi,0,0,0,0
0314,vap_other,0,0,0,0
0314,vap_two,13,43,30,31
0314,vap_white,770,625,-145,683
0315,pop,2463,2542,79,2510
0315,pop_aian,27,14,-13,19
0315,pop_asian,106,133,27,122
0315,pop_black,51,61,10,57
0315,pop_hisp,348,544,196,466
0315,pop_nhpi,1,0,-1,0
0315,pop_other,2,17,15,11
0315,pop_two,53,89,36,75
0315,pop_white,1875,1684,-191,1760
0315,vap,1909,1974,65,1948
0315,vap_aian,18,8,-10,12
0315,vap_asian,70,92,22,83
0315,vap_black,36,42,6,40
0315,vap_hisp,203,379,176,309
0315,vap_nhpi,1,0,-1,0
0315,vap_other,1,14,13,9
0315,vap_two,29,62,33,49
0315,vap_white,1551,1377,-174,1447
0316,pop,1635,1679,44,1661
0316,pop_aian,14,20,6,18
0316,pop_asian,79,102,23,93
0316,pop_black,23,55,32,42
0316,pop_hisp,232,515,283,402
0316,pop_nhpi,2,0,-2,1
0316,pop_other,0,15,15,9
0316,pop_two,15,57,42,40
0316,pop_white,1270,915,-355,1057
0316,vap,1242,1243,1,1243
0316,vap_aian,11,13,2,12
0316,vap_asian,49,68,19,60
0316,vap_black,17,34,17,27
0316,vap_hisp,151,321,170,253
0316,vap_nhpi,2,0,-2,1
0316,vap_other,0,11,11,7
0316,vap_two,9,37,28,26
0316,vap_white,1003,759,-244,857
0317,pop,1578,1528,-50,1548
0317,pop_aian,9,11,2,10
0317,pop_asian,22,49,27,38
0317,pop_black,25,41,16,35
0317,pop_hisp,305,349,44,331
0317,pop_nhpi,0,3,3,2
0317,pop_other,2,1,-1,1
0317,pop_two,38,68,30,56
0317,pop_white,1177,1006,-171,1074
0317,vap,1191,1186,-5,1188
0317,vap_aian,8,7,-1,7
0317,vap_asian,15,31,16,25
0317,vap_black,16,31,15,25
0317,vap_hisp,189,224,35,210
0317,vap_nhpi,0,3,3,2
0317,vap_other,1,0,-1,0
0317,vap_two,22,36,14,30
0317,vap_white,940,854,-86,888
0319,pop,0,0,0,0
0319,pop_aian,0,0,0,0
0319,pop_asian,0,0,0,0
0319,pop_black,0,0,0,0
0319,pop_hisp,0,0,0,0
0319,pop_nhpi,0,0,0,0
0319,pop_other,0,0,0,0
0319,pop_two,0,0,0,0
0319,pop_white,0,0,0,0
0319,vap,0,0,0,0
0319,vap_aian,0,0,0,0
0319,vap_asian,0,0,0,0
0319,vap_black,0,0,0,0
0319,vap_hisp,0,0,0,0
0319,vap_nhpi,0,0,0,0
0319,vap_other,0,0,0,0
0319,vap_two,0,0,0,0
0319,vap_white,0,0,0,0
0320,pop,96,116,20,108
0320,pop_aian,2,0,-2,1
0320,pop_asian,0,1,1,1
0320,pop_black,29,65,36,51
0320,pop_hisp,15,25,10,21
0320,pop_nhpi,0,0,0,0
0320,pop_other,0,2,2,1
0320,pop_two,5,0,-5,2
0320,pop_white,45,23,-22,32
0320,vap,84,93,9,89
0320,vap_aian,2,0,-2,1
0320,vap_asian,0,1,1,1
0320,vap_black,26,48,22,39
0320,vap_hisp,14,19,5,17
0320,vap_nhpi,0,0,0,0
0320,vap_other,0,2,2,1
0320,vap_two,2,0,-2,1
0320,vap_white,40,23,-17,30
0321,pop,1327,1074,-253,1175
0321,pop_aian,8,4,-4,6
0321,pop_asian,49,19,-30,31
0321,pop_black,147,169,22,160
0321,pop_hisp,983,807,-176,877
0321,pop_nhpi,1,1,0,1
0321,pop_other,0,2,2,1
0321,pop_two,14,23,9,19
0321,pop_white,125,49,-76,79
0321,vap,813,718,-95,756
0321,vap_aian,6,1,-5,3
0321,vap_asian,34,12,-22,21
0321,vap_black,73,111,38,96
0321,vap_hisp,589,542,-47,561
0321,vap_nhpi,1,0,-1,0
0321,vap_other,0,1,1,1
0321,vap_two,6,8,2,7
0321,vap_white,104,43,-61,67
0322,pop,522,551,29,539
0322,pop_aian,4,0,-4,2
0322,pop_asian,7,5,-2,6
0322,pop_black,29,47,18,40
0322,pop_hisp,362,422,60,398
0322,pop_nhpi,2,0,-2,1
0322,pop_other,2,4,2,3
0322,pop_two,5,13,8,10
0322,pop_white,111,60,-51,80
0322,vap,338,337,-1,337
0322,vap_aian,3,0,-3,1
0322,vap_asian,5,4,-1,4
0322,vap_black,16,16,0,16
0322,vap_hisp,211,255,44,237
0322,vap_nhpi,0,0,0,0
0322,vap_other,0,4,4,2
0322,vap_two,1,3,2,2
0322,vap_white,102,55,-47,74
0323,pop,1239,1179,-60,1203
0323,pop_aian,21,12,-9,16
0323,pop_asian,17,99,82,66
0323,pop_black,75,61,-14,67
0323,pop_hisp,911,870,-41,886
0323,pop_nhpi,0,0,0,0
0323,pop_other,0,2,2,1
0323,pop_two,9,22,13,17
0323,pop_white,206,113,-93,150
0323,vap,784,817,33,804
0323,vap_aian,14,11,-3,12
0323,vap_asian,6,52,46,34
0323,vap_black,49,43,-6,45
0323,vap_hisp,540,597,57,574
0323,vap_nhpi,0,0,0,0
0323,vap_other,0,2,2,1
0323,vap_two,4,10,6,8
0323,vap_white,171,102,-69,130
0324,pop,727,741,14,735
0324,pop_aian,1,3,2,2
0324,pop_asian,11,29,18,22
0324,pop_black,64,67,3,66
0324,pop_hisp,527,526,-1,526
0324,pop_nhpi,0,2,2,1
0324,pop_other,0,7,7,4
0324,pop_two,18,13,-5,15
0324,pop_white,106,94,-12,99
0324,vap,455,454,-1,454
0324,vap_aian,1,3,2,2
0324,vap_asian,4,13,9,9
0324,vap_black,30,31,1,31
0324,vap_hisp,323,315,-8,318
0324,vap_nhpi,0,2,2,1
0324,vap_other,0,4,4,2
0324,vap_two,5,9,4,7
0324,vap_white,92,77,-15,83
0325,pop,666,752,86,718
0325,pop_aian,9,8,-1,8
0325,pop_asian,21,23,2,22
0325,pop_black,19,42,23,33
0325,pop_hisp,167,179,12,174
0325,pop_nhpi,0,0,0,0
0325,pop_other,1,0,-1,0
0325,pop_two,18,40,22,31
0325,pop_white,431,460,29,448
0325,vap,508,582,74,552
0325,vap_aian,6,7,1,7
0325,vap_asian,9,12,3,11
0325,vap_black,14,36,22,27
0325,vap_hisp,105,110,5,108
0325,vap_nhpi,0,0,0,0
0325,vap_other,1,0,-1,0
0325,vap_two,7,33,26,23
0325,vap_white,366,384,18,377
0326,pop,4,27,23,18
0326,pop_aian,0,0,0,0
0326,pop_asian,0,0,0,0
0326,pop_black,0,0,0,0
0326,pop_hisp,3,23,20,15
0326,pop_nhpi,0,0,0,0
0326,pop_other,0,0,0,0
0326,pop_two,0,3,3,2
0326,pop_white,1,1,0,1
0326,vap,2,14,12,9
0326,vap_aian,0,0,0,0
0326,vap_asian,0,0,0,0
0326,vap_black,0,0,0,0
0326,vap_hisp,2,11,9,7
0326,vap_nhpi,0,0,0,0
0326,vap_other,0,0,0,0
0326,vap_two,0,2,2,1
0326,vap_white,1,1,0,1
0327,pop,1,0,-1,0
0327,pop_aian,0,0,0,0
0327,pop_asian,0,0,0,0
0327,pop_black,0,0,0,0
0327,pop_hisp,1,0,-1,0
0327,pop_nhpi,0,0,0,0
0327,pop_other,0,0,0,0
0327,pop_two,0,0,0,0
0327,pop_white,0,0,0,0
0327,vap,1,0,-1,0
0327,vap_aian,0,0,0,0
0327,vap_asian,0,0,0,0
0327,vap_black,0,0,0,0
0327,vap_hisp,1,0,-1,0
0327,vap_nhpi,0,0,0,0
0327,vap_other,0,0,0,0
0327,vap_two,0,0,0,0
0327,vap_white,0,0,0,0
