ward_2001,group,2000,2010,decade_change,interpolated_2004,interpolated_2008
0212,PERSONS,2867,3145,278,2978,3089
0212,WHITE,724,352,-372,575,426
0212,BLACK,239,288,49,259,278
0212,HISPANIC,1715,2365,650,1975,2235
0212,ASIAN,97,64,-33,84,71
0212,AMINDIAN,60,27,-33,47,34
0212,PISLAND,0,0,0,0,0
0212,OTHER,11,1,-10,7,3
0212,OTHERMLT,21,48,27,32,43
0212,PERSONS18,1773,1957,184,1847,1920
0212,WHITE18,588,291,-297,469,350
0212,BLACK18,99,162,63,124,149
0212,HISPANIC18,1000,1426,426,1170,1341
0212,ASIAN18,36,38,2,37,38
0212,AMINDIAN18,34,23,-11,30,25
0212,PISLAND18,0,0,0,0,0
0212,OTHER18,9,1,-8,6,3
0212,OTHERMLT18,7,16,9,11,14
0213,PERSONS,1737,1749,12,1742,1747
0213,WHITE,462,308,-154,400,339
0213,BLACK,105,91,-14,99,94
0213,HISPANIC,1077,1270,193,1154,1231
0213,ASIAN,43,45,2,44,45
0213,AMINDIAN,24,15,-9,20,17
0213,PISLAND,1,0,-1,1,0
0213,OTHER,13,1,-12,8,3
0213,OTHERMLT,12,19,7,15,18
0213,PERSONS18,1087,1105,18,1094,1101
0213,WHITE18,378,264,-114,332,287
0213,BLACK18,46,53,7,49,52
0213,HISPANIC18,613,745,132,666,719
0213,ASIAN18,19,28,9,23,26
0213,AMINDIAN18,14,8,-6,12,9
0213,PISLAND18,1,0,-1,1,0
0213,OTHER18,10,0,-10,6,2
0213,OTHERMLT18,6,7,1,6,7
0214,PERSONS,1411,1407,-4,1409,1408
0214,WHITE,432,203,-229,340,249
0214,BLACK,47,94,47,66,85
0214,HISPANIC,811,1033,222,900,989
0214,ASIAN,66,24,-42,49,32
0214,AMINDIAN,31,25,-6,29,26
0214,PISLAND,4,0,-4,2,1
0214,OTHER,12,2,-10,8,4
0214,OTHERMLT,8,26,18,15,22
0214,PERSONS18,890,911,21,898,907
0214,WHITE18,347,174,-173,278,209
0214,BLACK18,16,60,44,34,51
0214,HISPANIC18,463,634,171,531,600
0214,ASIAN18,26,18,-8,23,20
0214,AMINDIAN18,21,19,-2,20,19
0214,PISLAND18,2,0,-2,1,0
0214,OTHER18,9,1,-8,6,3
0214,OTHERMLT18,6,5,-1,6,5
0215,PERSONS,2371,2602,231,2463,2556
0215,WHITE,781,348,-433,608,435
0215,BLACK,108,157,49,128,147
0215,HISPANIC,1277,1928,651,1537,1798
0215,ASIAN,122,73,-49,102,83
0215,AMINDIAN,43,40,-3,42,41
0215,PISLAND,0,0,0,0,0
0215,OTHER,11,4,-7,8,5
0215,OTHERMLT,29,52,23,38,47
0215,PERSONS18,1518,1584,66,1544,1571
0215,WHITE18,625,284,-341,489,352
0215,BLACK18,48,102,54,70,91
0215,HISPANIC18,736,1106,370,884,1032
0215,ASIAN18,70,40,-30,58,46
0215,AMINDIAN18,23,25,2,24,25
0215,PISLAND18,0,0,0,0,0
0215,OTHER18,6,4,-2,5,4
0215,OTHERMLT18,10,23,13,15,20
0216,PERSONS,1405,1425,20,1413,1421
0216,WHITE,1283,1123,-160,1219,1155
0216,BLACK,7,14,7,10,13
0216,HISPANIC,81,220,139,137,192
0216,ASIAN,13,24,11,17,22
0216,AMINDIAN,16,14,-2,15,14
0216,PISLAND,2,0,-2,1,0
0216,OTHER,3,0,-3,2,1
0216,OTHERMLT,0,30,30,12,24
0216,PERSONS18,1075,1105,30,1087,1099
0216,WHITE18,1010,934,-76,980,949
0216,BLACK18,2,10,8,5,8
0216,HISPANIC18,44,127,83,77,110
0216,ASIAN18,5,16,11,9,14
0216,AMINDIAN18,11,10,-1,11,10
0216,PISLAND18,0,0,0,0,0
0216,OTHER18,3,0,-3,2,1
0216,OTHERMLT18,0,8,8,3,6
0217,PERSONS,1520,1484,-36,1506,1491
0217,WHITE,1346,1195,-151,1286,1225
0217,BLACK,7,17,10,11,15
0217,HISPANIC,130,214,84,164,197
0217,ASIAN,16,14,-2,15,14
0217,AMINDIAN,19,14,-5,17,15
0217,PISLAND,0,0,0,0,0
0217,OTHER,2,5,3,3,4
0217,OTHERMLT,0,25,25,10,20
0217,PERSONS18,1205,1165,-40,1189,1173
0217,WHITE18,1107,982,-125,1057,1007
0217,BLACK18,4,10,6,6,9
0217,HISPANIC18,67,135,68,94,121
0217,ASIAN18,13,9,-4,11,10
0217,AMINDIAN18,12,10,-2,11,10
0217,PISLAND18,0,0,0,0,0
0217,OTHER18,2,3,1,2,3
0217,OTHERMLT18,0,16,16,6,13
0218,PERSONS,1640,1903,263,1745,1850
0218,WHITE,1423,1116,-307,1300,1177
0218,BLACK,10,44,34,24,37
0218,HISPANIC,162,670,508,365,568
0218,ASIAN,12,18,6,14,17
0218,AMINDIAN,20,23,3,21,22
0218,PISLAND,0,0,0,0,0
0218,OTHER,6,1,-5,4,2
0218,OTHERMLT,7,31,24,17,26
0218,PERSONS18,1323,1387,64,1349,1374
0218,WHITE18,1183,906,-277,1072,961
0218,BLACK18,2,30,28,13,24
0218,HISPANIC18,108,410,302,229,350
0218,ASIAN18,11,13,2,12,13
0218,AMINDIAN18,15,12,-3,14,13
0218,PISLAND18,0,0,0,0,0
0218,OTHER18,3,1,-2,2,1
0218,OTHERMLT18,1,15,14,7,12
0106,PERSONS,1586,1400,-186,1512,1437
0106,WHITE,119,181,62,144,169
0106,BLACK,1146,930,-216,1060,973
0106,HISPANIC,294,225,-69,266,239
0106,ASIAN,15,2,-13,10,5
0106,AMINDIAN,6,3,-3,5,4
0106,PISLAND,0,0,0,0,0
0106,OTHER,0,1,1,0,1
0106,OTHERMLT,6,58,52,27,48
0106,PERSONS18,952,912,-40,936,920
0106,WHITE18,97,157,60,121,145
0106,BLACK18,659,574,-85,625,591
0106,HISPANIC18,178,141,-37,163,148
0106,ASIAN18,12,2,-10,8,4
0106,AMINDIAN18,4,3,-1,4,3
0106,PISLAND18,0,0,0,0,0
0106,OTHER18,0,1,1,0,1
0106,OTHERMLT18,2,34,32,15,28
0107,PERSONS,1576,1334,-242,1479,1382
0107,WHITE,89,56,-33,76,63
0107,BLACK,1399,1176,-223,1310,1221
0107,HISPANIC,31,57,26,41,52
0107,ASIAN,14,1,-13,9,4
0107,AMINDIAN,9,5,-4,7,6
0107,PISLAND,1,1,0,1,1
0107,OTHER,3,1,-2,2,1
0107,OTHERMLT,30,37,7,33,36
0107,PERSONS18,937,876,-61,913,888
0107,WHITE18,58,48,-10,54,50
0107,BLACK18,833,775,-58,810,787
0107,HISPANIC18,20,30,10,24,28
0107,ASIAN18,5,1,-4,3,2
0107,AMINDIAN18,4,3,-1,4,3
0107,PISLAND18,0,1,1,0,1
0107,OTHER18,2,1,-1,2,1
0107,OTHERMLT18,15,17,2,16,17
0108,PERSONS,1754,1431,-323,1625,1496
0108,WHITE,36,37,1,36,37
0108,BLACK,1688,1279,-409,1524,1361
0108,HISPANIC,15,51,36,29,44
0108,ASIAN,1,10,9,5,8
0108,AMINDIAN,3,13,10,7,11
0108,PISLAND,0,0,0,0,0
0108,OTHER,2,0,-2,1,0
0108,OTHERMLT,9,41,32,22,35
0108,PERSONS18,1093,974,-119,1045,998
0108,WHITE18,33,34,1,33,34
0108,BLACK18,1044,873,-171,976,907
0108,HISPANIC18,5,31,26,15,26
0108,ASIAN18,1,9,8,4,7
0108,AMINDIAN18,2,8,6,4,7
0108,PISLAND18,0,0,0,0,0
0108,OTHER18,2,0,-2,1,0
0108,OTHERMLT18,6,19,13,11,16
0109,PERSONS,3073,2520,-553,2852,2631
0109,WHITE,75,31,-44,57,40
0109,BLACK,2873,2341,-532,2660,2447
0109,HISPANIC,66,60,-6,64,61
0109,ASIAN,15,32,17,22,29
0109,AMINDIAN,7,5,-2,6,5
0109,PISLAND,0,0,0,0,0
0109,OTHER,4,1,-3,3,2
0109,OTHERMLT,33,50,17,40,47
0109,PERSONS18,1769,1548,-221,1681,1592
0109,WHITE18,50,28,-22,41,32
0109,BLACK18,1656,1438,-218,1569,1482
0109,HISPANIC18,35,32,-3,34,33
0109,ASIAN18,9,20,11,13,18
0109,AMINDIAN18,5,5,0,5,5
0109,PISLAND18,0,0,0,0,0
0109,OTHER18,0,1,1,0,1
0109,OTHERMLT18,14,24,10,18,22
0011,PERSONS,1606,1373,-233,1513,1420
0011,WHITE,94,63,-31,82,69
0011,BLACK,1455,1244,-211,1371,1286
0011,HISPANIC,21,36,15,27,33
0011,ASIAN,14,5,-9,10,7
0011,AMINDIAN,3,2,-1,3,2
0011,PISLAND,0,0,0,0,0
0011,OTHER,4,3,-1,4,3
0011,OTHERMLT,15,20,5,17,19
0011,PERSONS18,1046,989,-57,1023,1000
0011,WHITE18,78,55,-23,69,60
0011,BLACK18,932,894,-38,917,902
0011,HISPANIC18,16,22,6,18,21
0011,ASIAN18,8,4,-4,6,5
0011,AMINDIAN18,3,1,-2,2,1
0011,PISLAND18,0,0,0,0,0
0011,OTHER18,0,1,1,0,1
0011,OTHERMLT18,9,12,3,10,11
0110,PERSONS,2173,2896,723,2462,2751
0110,WHITE,640,1774,1134,1094,1547
0110,BLACK,1119,699,-420,951,783
0110,HISPANIC,357,260,-97,318,279
0110,ASIAN,25,80,55,47,69
0110,AMINDIAN,23,12,-11,19,14
0110,PISLAND,2,0,-2,1,0
0110,OTHER,2,6,4,4,5
0110,OTHERMLT,5,65,60,29,53
0110,PERSONS18,1495,2418,923,1864,2233
0110,WHITE18,572,1644,1072,1001,1430
0110,BLACK18,636,477,-159,572,509
0110,HISPANIC18,241,181,-60,217,193
0110,ASIAN18,23,71,48,42,61
0110,AMINDIAN18,16,9,-7,13,10
0110,PISLAND18,2,0,-2,1,0
0110,OTHER18,1,3,2,2,3
0110,OTHERMLT18,4,33,29,16,27
0111,PERSONS,1018,1002,-16,1012,1005
0111,WHITE,220,239,19,228,235
0111,BLACK,740,716,-24,730,721
0111,HISPANIC,40,23,-17,33,26
0111,ASIAN,7,11,4,9,10
0111,AMINDIAN,5,2,-3,4,3
0111,PISLAND,0,0,0,0,0
0111,OTHER,1,1,0,1,1
0111,OTHERMLT,5,10,5,7,9
0111,PERSONS18,754,726,-28,743,732
0111,WHITE18,206,216,10,210,214
0111,BLACK18,500,472,-28,489,478
0111,HISPANIC18,30,18,-12,25,20
0111,ASIAN18,7,11,4,9,10
0111,AMINDIAN18,5,2,-3,4,3
0111,PISLAND18,0,0,0,0,0
0111,OTHER18,1,1,0,1,1
0111,OTHERMLT18,5,6,1,5,6
0112,PERSONS,1716,1763,47,1735,1754
0112,WHITE,24,121,97,63,102
0112,BLACK,1630,1506,-124,1580,1531
0112,HISPANIC,45,105,60,69,93
0112,ASIAN,6,7,1,6,7
0112,AMINDIAN,2,7,5,4,6
0112,PISLAND,0,0,0,0,0
0112,OTHER,0,1,1,0,1
0112,OTHERMLT,9,16,7,12,15
0112,PERSONS18,1003,1187,184,1077,1150
0112,WHITE18,24,111,87,59,94
0112,BLACK18,946,993,47,965,984
0112,HISPANIC18,24,61,37,39,54
0112,ASIAN18,1,6,5,3,5
0112,AMINDIAN18,1,5,4,3,4
0112,PISLAND18,0,0,0,0,0
0112,OTHER18,0,1,1,0,1
0112,OTHERMLT18,7,10,3,8,9
0020,PERSONS,1942,1849,-93,1905,1868
0020,WHITE,543,247,-296,425,306
0020,BLACK,1209,1309,100,1249,1289
0020,HISPANIC,66,108,42,83,100
0020,ASIAN,99,137,38,114,129
0020,AMINDIAN,9,6,-3,8,7
0020,PISLAND,1,0,-1,1,0
0020,OTHER,2,5,3,3,4
0020,OTHERMLT,13,37,24,23,32
0020,PERSONS18,1192,1167,-25,1182,1172
0020,WHITE18,443,223,-220,355,267
0020,BLACK18,656,792,136,710,765
0020,HISPANIC18,38,52,14,44,49
0020,ASIAN18,47,78,31,59,72
0020,AMINDIAN18,2,5,3,3,4
0020,PISLAND18,1,0,-1,1,0
0020,OTHER18,0,2,2,1,2
0020,OTHERMLT18,5,15,10,9,13
0200,PERSONS,3082,3586,504,3284,3485
0200,WHITE,2600,2291,-309,2476,2353
0200,BLACK,99,245,146,157,216
0200,HISPANIC,255,780,525,465,675
0200,ASIAN,47,152,105,89,131
0200,AMINDIAN,42,23,-19,34,27
0200,PISLAND,3,4,1,3,4
0200,OTHER,30,0,-30,18,6
0200,OTHERMLT,6,91,85,40,74
0200,PERSONS18,2559,2829,270,2667,2775
0200,WHITE18,2216,1971,-245,2118,2020
0200,BLACK18,82,171,89,118,153
0200,HISPANIC18,166,513,347,305,444
0200,ASIAN18,38,117,79,70,101
0200,AMINDIAN18,28,20,-8,25,22
0200,PISLAND18,3,3,0,3,3
0200,OTHER18,21,0,-21,13,4
0200,OTHERMLT18,5,34,29,17,28
0201,PERSONS,1342,1941,599,1582,1821
0201,WHITE,417,1121,704,699,980
0201,BLACK,51,153,102,92,133
0201,HISPANIC,833,584,-249,733,634
0201,ASIAN,6,26,20,14,22
0201,AMINDIAN,21,22,1,21,22
0201,PISLAND,0,1,1,0,1
0201,OTHER,8,3,-5,6,4
0201,OTHERMLT,6,31,25,16,26
0201,PERSONS18,1003,1680,677,1274,1545
0201,WHITE18,388,1070,682,661,934
0201,BLACK18,33,124,91,69,106
0201,HISPANIC18,548,417,-131,496,443
0201,ASIAN18,5,26,21,13,22
0201,AMINDIAN18,16,17,1,16,17
0201,PISLAND18,0,1,1,0,1
0201,OTHER18,8,3,-5,6,4
0201,OTHERMLT18,5,22,17,12,19
0202,PERSONS,2486,2262,-224,2396,2307
0202,WHITE,424,345,-79,392,361
0202,BLACK,216,342,126,266,317
0202,HISPANIC,1803,1479,-324,1673,1544
0202,ASIAN,10,15,5,12,14
0202,AMINDIAN,24,27,3,25,26
0202,PISLAND,0,0,0,0,0
0202,OTHER,2,3,1,2,3
0202,OTHERMLT,7,51,44,25,42
0202,PERSONS18,1646,1520,-126,1596,1545
0202,WHITE18,378,309,-69,350,323
0202,BLACK18,117,193,76,147,178
0202,HISPANIC18,1123,959,-164,1057,992
0202,ASIAN18,6,11,5,8,10
0202,AMINDIAN18,14,21,7,17,20
0202,PISLAND18,0,0,0,0,0
0202,OTHER18,2,1,-1,2,1
0202,OTHERMLT18,6,26,20,14,22
0197,PERSONS,2153,2097,-56,2131,2108
0197,WHITE,1986,1775,-211,1902,1817
0197,BLACK,10,10,0,10,10
0197,HISPANIC,105,185,80,137,169
0197,ASIAN,32,79,47,51,70
0197,AMINDIAN,15,10,-5,13,11
0197,PISLAND,4,2,-2,3,2
0197,OTHER,0,7,7,3,6
0197,OTHERMLT,1,29,28,12,23
0197,PERSONS18,1700,1666,-34,1686,1673
0197,WHITE18,1600,1459,-141,1544,1487
0197,BLACK18,2,9,7,5,8
0197,HISPANIC18,61,112,51,81,102
0197,ASIAN18,19,57,38,34,49
0197,AMINDIAN18,13,9,-4,11,10
0197,PISLAND18,4,2,-2,3,2
0197,OTHER18,0,3,3,1,2
0197,OTHERMLT18,1,15,14,7,12
0154,PERSONS,2201,2265,64,2227,2252
0154,WHITE,843,415,-428,672,501
0154,BLACK,1094,1338,244,1192,1289
0154,HISPANIC,71,62,-9,67,64
0154,ASIAN,173,365,192,250,327
0154,AMINDIAN,10,8,-2,9,8
0154,PISLAND,1,0,-1,1,0
0154,OTHER,4,0,-4,2,1
0154,OTHERMLT,5,77,72,34,63
0154,PERSONS18,1466,1441,-25,1456,1446
0154,WHITE18,698,372,-326,568,437
0154,BLACK18,639,798,159,703,766
0154,HISPANIC18,38,29,-9,34,31
0154,ASIAN18,76,210,134,130,183
0154,AMINDIAN18,7,4,-3,6,5
0154,PISLAND18,1,0,-1,1,0
0154,OTHER18,4,0,-4,2,1
0154,OTHERMLT18,3,28,25,13,23
0155,PERSONS,1956,1983,27,1967,1978
0155,WHITE,907,492,-415,741,575
0155,BLACK,896,1180,284,1010,1123
0155,HISPANIC,79,83,4,81,82
0155,ASIAN,45,148,103,86,127
0155,AMINDIAN,15,11,-4,13,12
0155,PISLAND,0,2,2,1,2
0155,OTHER,6,6,0,6,6
0155,OTHERMLT,8,61,53,29,50
0155,PERSONS18,1350,1338,-12,1345,1340
0155,WHITE18,695,414,-281,583,470
0155,BLACK18,573,759,186,647,722
0155,HISPANIC18,46,44,-2,45,44
0155,ASIAN18,24,84,60,48,72
0155,AMINDIAN18,7,11,4,9,10
0155,PISLAND18,0,2,2,1,2
0155,OTHER18,2,2,0,2,2
0155,OTHERMLT18,3,22,19,11,18
0156,PERSONS,2191,2070,-121,2143,2094
0156,WHITE,490,192,-298,371,252
0156,BLACK,1617,1770,153,1678,1739
0156,HISPANIC,42,49,7,45,48
0156,ASIAN,8,5,-3,7,6
0156,AMINDIAN,17,10,-7,14,11
0156,PISLAND,0,0,0,0,0
0156,OTHER,2,2,0,2,2
0156,OTHERMLT,15,42,27,26,37
0156,PERSONS18,1344,1333,-11,1340,1335
0156,WHITE18,413,180,-233,320,227
0156,BLACK18,885,1096,211,969,1054
0156,HISPANIC18,25,28,3,26,27
0156,ASIAN18,6,5,-1,6,5
0156,AMINDIAN18,11,5,-6,9,6
0156,PISLAND18,0,0,0,0,0
0156,OTHER18,1,0,-1,1,0
0156,OTHERMLT18,3,19,16,9,16
0182,PERSONS,1200,1389,189,1276,1351
0182,WHITE,717,385,-332,584,451
0182,BLACK,19,52,33,32,45
0182,HISPANIC,405,896,491,601,798
0182,ASIAN,25,9,-16,19,12
0182,AMINDIAN,23,20,-3,22,21
0182,PISLAND,0,0,0,0,0
0182,OTHER,6,1,-5,4,2
0182,OTHERMLT,5,26,21,13,22
0182,PERSONS18,845,927,82,878,911
0182,WHITE18,566,339,-227,475,384
0182,BLACK18,11,27,16,17,24
0182,HISPANIC18,230,527,297,349,468
0182,ASIAN18,14,7,-7,11,8
0182,AMINDIAN18,19,16,-3,18,17
0182,PISLAND18,0,0,0,0,0
0182,OTHER18,2,1,-1,2,1
0182,OTHERMLT18,3,10,7,6,9
0183,PERSONS,1192,1202,10,1196,1200
0183,WHITE,977,680,-297,858,739
0183,BLACK,32,108,76,62,93
0183,HISPANIC,111,353,242,208,305
0183,ASIAN,54,18,-36,40,25
0183,AMINDIAN,10,15,5,12,14
0183,PISLAND,0,0,0,0,0
0183,OTHER,4,0,-4,2,1
0183,OTHERMLT,4,28,24,14,23
0183,PERSONS18,991,908,-83,958,925
0183,WHITE18,834,585,-249,734,635
0183,BLACK18,23,83,60,47,71
0183,HISPANIC18,81,200,119,129,176
0183,ASIAN18,42,16,-26,32,21
0183,AMINDIAN18,9,12,3,10,11
0183,PISLAND18,0,0,0,0,0
0183,OTHER18,2,0,-2,1,0
0183,OTHERMLT18,0,12,12,5,10
0184,PERSONS,2012,2129,117,2059,2106
0184,WHITE,1836,1628,-208,1753,1670
0184,BLACK,20,68,48,39,58
0184,HISPANIC,124,339,215,210,296
0184,ASIAN,16,40,24,26,35
0184,AMINDIAN,10,11,1,10,11
0184,PISLAND,1,0,-1,1,0
0184,OTHER,1,6,5,3,5
0184,OTHERMLT,4,37,33,17,30
0184,PERSONS18,1697,1691,-6,1695,1692
0184,WHITE18,1578,1368,-210,1494,1410
0184,BLACK18,17,51,34,31,44
0184,HISPANIC18,78,222,144,136,193
0184,ASIAN18,11,29,18,18,25
0184,AMINDIAN18,10,7,-3,9,8
0184,PISLAND18,1,0,-1,1,0
0184,OTHER18,1,1,0,1,1
0184,OTHERMLT18,1,13,12,6,11
0185,PERSONS,1208,1222,14,1214,1219
0185,WHITE,1119,1003,-116,1073,1026
0185,BLACK,7,27,20,15,23
0185,HISPANIC,51,160,109,95,138
0185,ASIAN,17,5,-12,12,7
0185,AMINDIAN,11,7,-4,9,8
0185,PISLAND,0,0,0,0,0
0185,OTHER,0,1,1,0,1
0185,OTHERMLT,3,19,16,9,16
0185,PERSONS18,976,958,-18,969,962
0185,WHITE18,920,838,-82,887,854
0185,BLACK18,4,11,7,7,10
0185,HISPANIC18,32,83,51,52,73
0185,ASIAN18,12,5,-7,9,6
0185,AMINDIAN18,7,7,0,7,7
0185,PISLAND18,0,0,0,0,0
0185,OTHER18,0,1,1,0,1
0185,OTHERMLT18,1,13,12,6,11
0235,PERSONS,2594,2728,134,2648,2701
0235,WHITE,1325,936,-389,1169,1014
0235,BLACK,136,225,89,172,207
0235,HISPANIC,979,1389,410,1143,1307
0235,ASIAN,57,38,-19,49,42
0235,AMINDIAN,81,42,-39,65,50
0235,PISLAND,0,14,14,6,11
0235,OTHER,7,9,2,8,9
0235,OTHERMLT,9,75,66,35,62
0235,PERSONS18,1773,1807,34,1787,1800
0235,WHITE18,1070,792,-278,959,848
0235,BLACK18,57,132,75,87,117
0235,HISPANIC18,543,801,258,646,749
0235,ASIAN18,38,23,-15,32,26
0235,AMINDIAN18,53,25,-28,42,31
0235,PISLAND18,0,6,6,2,5
0235,OTHER18,6,1,-5,4,2
0235,OTHERMLT18,6,27,21,14,23
0236,PERSONS,2201,2061,-140,2145,2089
0236,WHITE,1659,1408,-251,1559,1458
0236,BLACK,51,114,63,76,101
0236,HISPANIC,355,385,30,367,379
0236,ASIAN,53,41,-12,48,43
0236,AMINDIAN,65,29,-36,51,36
0236,PISLAND,3,2,-1,3,2
0236,OTHER,11,1,-10,7,3
0236,OTHERMLT,4,81,77,35,66
0236,PERSONS18,1685,1698,13,1690,1695
0236,WHITE18,1354,1253,-101,1314,1273
0236,BLACK18,27,91,64,53,78
0236,HISPANIC18,217,253,36,231,246
0236,ASIAN18,31,37,6,33,36
0236,AMINDIAN18,43,19,-24,33,24
0236,PISLAND18,2,2,0,2,2
0236,OTHER18,10,1,-9,6,3
0236,OTHERMLT18,1,42,41,17,34
0237,PERSONS,1541,1418,-123,1492,1443
0237,WHITE,1283,1165,-118,1236,1189
0237,BLACK,42,42,0,42,42
0237,HISPANIC,166,133,-33,153,140
0237,ASIAN,5,9,4,7,8
0237,AMINDIAN,37,21,-16,31,24
0237,PISLAND,1,1,0,1,1
0237,OTHER,3,2,-1,3,2
0237,OTHERMLT,4,45,41,20,37
0237,PERSONS18,1182,1210,28,1193,1204
0237,WHITE18,1049,1051,2,1050,1051
0237,BLACK18,14,29,15,20,26
0237,HISPANIC18,87,86,-1,87,86
0237,ASIAN18,5,9,4,7,8
0237,AMINDIAN18,24,13,-11,20,15
0237,PISLAND18,1,1,0,1,1
0237,OTHER18,1,1,0,1,1
0237,OTHERMLT18,1,20,19,9,16
0238,PERSONS,1502,1397,-105,1460,1418
0238,WHITE,1396,1245,-151,1336,1275
0238,BLACK,12,15,3,13,14
0238,HISPANIC,59,85,26,69,80
0238,ASIAN,13,19,6,15,18
0238,AMINDIAN,17,7,-10,13,9
0238,PISLAND,0,1,1,0,1
0238,OTHER,5,4,-1,5,4
0238,OTHERMLT,0,21,21,8,17
0238,PERSONS18,1295,1223,-72,1266,1237
0238,WHITE18,1225,1119,-106,1183,1140
0238,BLACK18,6,11,5,8,10
0238,HISPANIC18,35,58,23,44,53
0238,ASIAN18,10,15,5,12,14
0238,AMINDIAN18,14,6,-8,11,8
0238,PISLAND18,0,1,1,0,1
0238,OTHER18,5,2,-3,4,3
0238,OTHERMLT18,0,11,11,4,9
0129,PERSONS,1908,1681,-227,1817,1726
0129,WHITE,212,67,-145,154,96
0129,BLACK,1627,1534,-93,1590,1553
0129,HISPANIC,29,36,7,32,35
0129,ASIAN,18,16,-2,17,16
0129,AMINDIAN,5,12,7,8,11
0129,PISLAND,7,0,-7,4,1
0129,OTHER,6,0,-6,4,1
0129,OTHERMLT,4,16,12,9,14
0129,PERSONS18,1209,1055,-154,1147,1086
0129,WHITE18,192,63,-129,140,89
0129,BLACK18,976,946,-30,964,952
0129,HISPANIC18,16,23,7,19,22
0129,ASIAN18,14,8,-6,12,9
0129,AMINDIAN18,3,6,3,4,5
0129,PISLAND18,5,0,-5,3,1
0129,OTHER18,2,0,-2,1,0
0129,OTHERMLT18,2,9,7,5,8
0013,PERSONS,1610,1638,28,1621,1632
0013,WHITE,42,45,3,43,44
0013,BLACK,1505,1496,-9,1501,1498
0013,HISPANIC,37,35,-2,36,35
0013,ASIAN,6,1,-5,4,2
0013,AMINDIAN,5,4,-1,5,4
0013,PISLAND,0,0,0,0,0
0013,OTHER,4,2,-2,3,2
0013,OTHERMLT,11,55,44,29,46
0013,PERSONS18,1051,1113,62,1076,1101
0013,WHITE18,39,42,3,40,41
0013,BLACK18,975,1031,56,997,1020
0013,HISPANIC18,22,18,-4,20,19
0013,ASIAN18,4,1,-3,3,2
0013,AMINDIAN18,1,2,1,1,2
0013,PISLAND18,0,0,0,0,0
0013,OTHER18,3,0,-3,2,1
0013,OTHERMLT18,7,19,12,12,17
0130,PERSONS,1854,1510,-344,1716,1579
0130,WHITE,53,25,-28,42,31
0130,BLACK,1731,1413,-318,1604,1477
0130,HISPANIC,35,42,7,38,41
0130,ASIAN,9,8,-1,9,8
0130,AMINDIAN,9,2,-7,6,3
0130,PISLAND,0,0,0,0,0
0130,OTHER,5,0,-5,3,1
0130,OTHERMLT,12,20,8,15,18
0130,PERSONS18,989,893,-96,951,912
0130,WHITE18,48,25,-23,39,30
0130,BLACK18,912,828,-84,878,845
0130,HISPANIC18,13,22,9,17,20
0130,ASIAN18,3,5,2,4,5
0130,AMINDIAN18,4,2,-2,3,2
0130,PISLAND18,0,0,0,0,0
0130,OTHER18,2,0,-2,1,0
0130,OTHERMLT18,7,11,4,9,10
0131,PERSONS,1547,1318,-229,1455,1364
0131,WHITE,43,21,-22,34,25
0131,BLACK,1419,1211,-208,1336,1253
0131,HISPANIC,56,63,7,59,62
0131,ASIAN,19,15,-4,17,16
0131,AMINDIAN,2,0,-2,1,0
0131,PISLAND,0,1,1,0,1
0131,OTHER,1,2,1,1,2
0131,OTHERMLT,7,5,-2,6,5
0131,PERSONS18,818,795,-23,809,800
0131,WHITE18,39,18,-21,31,22
0131,BLACK18,739,728,-11,735,730
0131,HISPANIC18,26,35,9,30,33
0131,ASIAN18,8,7,-1,8,7
0131,AMINDIAN18,1,0,-1,1,0
0131,PISLAND18,0,1,1,0,1
0131,OTHER18,0,2,2,1,2
0131,OTHERMLT18,5,4,-1,5,4
0132,PERSONS,2425,2402,-23,2416,2407
0132,WHITE,567,331,-236,473,378
0132,BLACK,173,247,74,203,232
0132,HISPANIC,1466,1690,224,1556,1645
0132,ASIAN,109,45,-64,83,58
0132,AMINDIAN,72,29,-43,55,38
0132,PISLAND,0,1,1,0,1
0132,OTHER,12,8,-4,10,9
0132,OTHERMLT,26,51,25,36,46
0132,PERSONS18,1513,1554,41,1529,1546
0132,WHITE18,430,281,-149,370,311
0132,BLACK18,84,157,73,113,142
0132,HISPANIC18,883,1041,158,946,1009
0132,ASIAN18,61,31,-30,49,37
0132,AMINDIAN18,37,20,-17,30,23
0132,PISLAND18,0,1,1,0,1
0132,OTHER18,4,4,0,4,4
0132,OTHERMLT18,14,19,5,16,18
0133,PERSONS,2015,2125,110,2059,2103
0133,WHITE,451,260,-191,375,298
0133,BLACK,183,271,88,218,253
0133,HISPANIC,1247,1503,256,1349,1452
0133,ASIAN,58,37,-21,50,41
0133,AMINDIAN,36,21,-15,30,24
0133,PISLAND,0,1,1,0,1
0133,OTHER,21,1,-20,13,5
0133,OTHERMLT,19,31,12,24,29
0133,PERSONS18,1222,1282,60,1246,1270
0133,WHITE18,347,218,-129,295,244
0133,BLACK18,66,140,74,96,125
0133,HISPANIC18,744,880,136,798,853
0133,ASIAN18,19,18,-1,19,18
0133,AMINDIAN18,19,13,-6,17,14
0133,PISLAND18,0,1,1,0,1
0133,OTHER18,16,0,-16,10,3
0133,OTHERMLT18,11,12,1,11,12
0134,PERSONS,2660,2779,119,2708,2755
0134,WHITE,872,433,-439,696,521
0134,BLACK,185,201,16,191,198
0134,HISPANIC,1249,1950,701,1529,1810
0134,ASIAN,218,92,-126,168,117
0134,AMINDIAN,80,51,-29,68,57
0134,PISLAND,0,1,1,0,1
0134,OTHER,39,1,-38,24,9
0134,OTHERMLT,17,50,33,30,43
0134,PERSONS18,1732,1797,65,1758,1784
0134,WHITE18,722,383,-339,586,451
0134,BLACK18,82,111,29,94,105
0134,HISPANIC18,739,1191,452,920,1101
0134,ASIAN18,111,58,-53,90,69
0134,AMINDIAN18,46,33,-13,41,36
0134,PISLAND18,0,1,1,0,1
0134,OTHER18,24,0,-24,14,5
0134,OTHERMLT18,8,20,12,13,18
0135,PERSONS,2646,2981,335,2780,2914
0135,WHITE,1369,750,-619,1121,874
0135,BLACK,73,195,122,122,171
0135,HISPANIC,995,1834,839,1331,1666
0135,ASIAN,144,119,-25,134,124
0135,AMINDIAN,51,33,-18,44,37
0135,PISLAND,0,0,0,0,0
0135,OTHER,7,1,-6,5,2
0135,OTHERMLT,7,49,42,24,41
0135,PERSONS18,1927,2033,106,1969,2012
0135,WHITE18,1170,663,-507,967,764
0135,BLACK18,35,131,96,73,112
0135,HISPANIC18,601,1105,504,803,1004
0135,ASIAN18,82,84,2,83,84
0135,AMINDIAN18,33,26,-7,30,27
0135,PISLAND18,0,0,0,0,0
0135,OTHER18,3,1,-2,2,1
0135,OTHERMLT18,3,23,20,11,19
0136,PERSONS,3151,3242,91,3187,3224
0136,WHITE,1178,600,-578,947,716
0136,BLACK,216,206,-10,212,208
0136,HISPANIC,1474,2300,826,1804,2135
0136,ASIAN,152,54,-98,113,74
0136,AMINDIAN,94,27,-67,67,40
0136,PISLAND,1,0,-1,1,0
0136,OTHER,24,4,-20,16,8
0136,OTHERMLT,12,51,39,28,43
0136,PERSONS18,2066,2121,55,2088,2110
0136,WHITE18,973,528,-445,795,617
0136,BLACK18,104,133,29,116,127
0136,HISPANIC18,836,1374,538,1051,1266
0136,ASIAN18,72,35,-37,57,42
0136,AMINDIAN18,57,19,-38,42,27
0136,PISLAND18,0,0,0,0,0
0136,OTHER18,17,4,-13,12,7
0136,OTHERMLT18,7,28,21,15,24
0137,PERSONS,2914,3305,391,3070,3227
0137,WHITE,1161,582,-579,929,698
0137,BLACK,179,132,-47,160,141
0137,HISPANIC,1317,2419,1102,1758,2199
0137,ASIAN,114,60,-54,92,71
0137,AMINDIAN,93,53,-40,77,61
0137,PISLAND,2,0,-2,1,0
0137,OTHER,17,3,-14,11,6
0137,OTHERMLT,31,56,25,41,51
0137,PERSONS18,1871,2133,262,1976,2081
0137,WHITE18,890,507,-383,737,584
0137,BLACK18,77,71,-6,75,72
0137,HISPANIC18,761,1448,687,1036,1311
0137,ASIAN18,58,43,-15,52,46
0137,AMINDIAN18,53,37,-16,47,40
0137,PISLAND18,2,0,-2,1,0
0137,OTHER18,14,3,-11,10,5
0137,OTHERMLT18,16,24,8,19,22
0138,PERSONS,3050,3596,546,3268,3487
0138,WHITE,1457,731,-726,1167,876
0138,BLACK,87,104,17,94,101
0138,HISPANIC,1271,2632,1361,1815,2360
0138,ASIAN,65,56,-9,61,58
0138,AMINDIAN,130,31,-99,90,51
0138,PISLAND,1,0,-1,1,0
0138,OTHER,14,2,-12,9,4
0138,OTHERMLT,25,40,15,31,37
0138,PERSONS18,2059,2296,237,2154,2249
0138,WHITE18,1128,624,-504,926,725
0138,BLACK18,39,69,30,51,63
0138,HISPANIC18,743,1510,767,1050,1357
0138,ASIAN18,44,50,6,46,49
0138,AMINDIAN18,82,22,-60,58,34
0138,PISLAND18,1,0,-1,1,0
0138,OTHER18,9,2,-7,6,3
0138,OTHERMLT18,13,19,6,15,18
0139,PERSONS,2081,1946,-135,2027,1973
0139,WHITE,539,277,-262,434,329
0139,BLACK,110,126,16,116,123
0139,HISPANIC,1329,1465,136,1383,1438
0139,ASIAN,40,19,-21,32,23
0139,AMINDIAN,54,22,-32,41,28
0139,PISLAND,1,0,-1,1,0
0139,OTHER,6,2,-4,4,3
0139,OTHERMLT,2,35,33,15,28
0139,PERSONS18,1330,1222,-108,1287,1244
0139,WHITE18,422,243,-179,350,279
0139,BLACK18,52,71,19,60,67
0139,HISPANIC18,803,869,66,829,856
0139,ASIAN18,17,9,-8,14,11
0139,AMINDIAN18,28,12,-16,22,15
0139,PISLAND18,1,0,-1,1,0
0139,OTHER18,5,2,-3,4,3
0139,OTHERMLT18,2,16,14,8,13
0272,PERSONS,2053,2115,62,2078,2103
0272,WHITE,723,307,-416,557,390
0272,BLACK,1131,1553,422,1300,1469
0272,HISPANIC,94,80,-14,88,83
0272,ASIAN,65,99,34,79,92
0272,AMINDIAN,15,7,-8,12,9
0272,PISLAND,0,0,0,0,0
0272,OTHER,6,1,-5,4,2
0272,OTHERMLT,19,68,49,39,58
0272,PERSONS18,1277,1244,-33,1264,1251
0272,WHITE18,575,255,-320,447,319
0272,BLACK18,593,862,269,701,808
0272,HISPANIC18,53,42,-11,49,44
0272,ASIAN18,36,54,18,43,50
0272,AMINDIAN18,11,6,-5,9,7
0272,PISLAND18,0,0,0,0,0
0272,OTHER18,1,1,0,1,1
0272,OTHERMLT18,8,24,16,14,21
0273,PERSONS,3166,3334,168,3233,3300
0273,WHITE,2436,2081,-355,2294,2152
0273,BLACK,534,888,354,676,817
0273,HISPANIC,95,138,43,112,129
0273,ASIAN,60,73,13,65,70
0273,AMINDIAN,24,17,-7,21,18
0273,PISLAND,2,4,2,3,4
0273,OTHER,7,4,-3,6,5
0273,OTHERMLT,8,129,121,56,105
0273,PERSONS18,2378,2443,65,2404,2430
0273,WHITE18,1918,1692,-226,1828,1737
0273,BLACK18,347,577,230,439,531
0273,HISPANIC18,53,68,15,59,65
0273,ASIAN18,37,46,9,41,44
0273,AMINDIAN18,15,12,-3,14,13
0273,PISLAND18,2,2,0,2,2
0273,OTHER18,1,0,-1,1,0
0273,OTHERMLT18,5,46,41,21,38
0275,PERSONS,2252,2099,-153,2191,2130
0275,WHITE,1321,1140,-181,1249,1176
0275,BLACK,683,711,28,694,705
0275,HISPANIC,106,122,16,112,119
0275,ASIAN,69,34,-35,55,41
0275,AMINDIAN,28,10,-18,21,14
0275,PISLAND,5,0,-5,3,1
0275,OTHER,20,11,-9,16,13
0275,OTHERMLT,20,71,51,40,61
0275,PERSONS18,1577,1543,-34,1563,1550
0275,WHITE18,1042,957,-85,1008,974
0275,BLACK18,387,437,50,407,427
0275,HISPANIC18,63,81,18,70,77
0275,ASIAN18,45,23,-22,36,27
0275,AMINDIAN18,14,10,-4,12,11
0275,PISLAND18,2,0,-2,1,0
0275,OTHER18,13,5,-8,10,7
0275,OTHERMLT18,11,30,19,19,26
0276,PERSONS,2758,2634,-124,2708,2659
0276,WHITE,2104,1911,-193,2027,1950
0276,BLACK,431,406,-25,421,411
0276,HISPANIC,114,158,44,132,149
0276,ASIAN,51,57,6,53,56
0276,AMINDIAN,31,12,-19,23,16
0276,PISLAND,4,0,-4,2,1
0276,OTHER,11,1,-10,7,3
0276,OTHERMLT,12,89,77,43,74
0276,PERSONS18,2027,1989,-38,2012,1997
0276,WHITE18,1675,1565,-110,1631,1587
0276,BLACK18,217,252,35,231,245
0276,HISPANIC18,71,87,16,77,84
0276,ASIAN18,30,41,11,34,39
0276,AMINDIAN18,21,11,-10,17,13
0276,PISLAND18,3,0,-3,2,1
0276,OTHER18,6,1,-5,4,2
0276,OTHERMLT18,4,32,28,15,26
0001,PERSONS,2276,2186,-90,2240,2204
0001,WHITE,817,638,-179,745,674
0001,BLACK,1264,1330,66,1290,1317
0001,HISPANIC,135,105,-30,123,111
0001,ASIAN,28,29,1,28,29
0001,AMINDIAN,11,7,-4,9,8
0001,PISLAND,0,0,0,0,0
0001,OTHER,5,1,-4,3,2
0001,OTHERMLT,16,76,60,40,64
0001,PERSONS18,1557,1562,5,1559,1561
0001,WHITE18,693,532,-161,629,564
0001,BLACK18,757,901,144,815,872
0001,HISPANIC18,64,68,4,66,67
0001,ASIAN18,20,18,-2,19,18
0001,AMINDIAN18,8,7,-1,8,7
0001,PISLAND18,0,0,0,0,0
0001,OTHER18,3,1,-2,2,1
0001,OTHERMLT18,12,35,23,21,30
0010,PERSONS,1900,1912,12,1905,1910
0010,WHITE,655,316,-339,519,384
0010,BLACK,1065,1370,305,1187,1309
0010,HISPANIC,73,86,13,78,83
0010,ASIAN,73,84,11,77,82
0010,AMINDIAN,8,9,1,8,9
0010,PISLAND,0,0,0,0,0
0010,OTHER,8,0,-8,5,2
0010,OTHERMLT,18,47,29,30,41
0010,PERSONS18,1296,1301,5,1298,1300
0010,WHITE18,541,288,-253,440,339
0010,BLACK18,654,880,226,744,835
0010,HISPANIC18,43,56,13,48,53
0010,ASIAN18,40,52,12,45,50
0010,AMINDIAN18,5,5,0,5,5
0010,PISLAND18,0,0,0,0,0
0010,OTHER18,3,0,-3,2,1
0010,OTHERMLT18,10,20,10,14,18
0100,PERSONS,1958,1841,-117,1911,1864
0100,WHITE,16,16,0,16,16
0100,BLACK,1905,1706,-199,1825,1746
0100,HISPANIC,24,64,40,40,56
0100,ASIAN,0,3,3,1,2
0100,AMINDIAN,3,3,0,3,3
0100,PISLAND,0,0,0,0,0
0100,OTHER,0,2,2,1,2
0100,OTHERMLT,10,47,37,25,40
0100,PERSONS18,1255,1191,-64,1229,1204
0100,WHITE18,15,12,-3,14,13
0100,BLACK18,1212,1119,-93,1175,1138
0100,HISPANIC18,19,34,15,25,31
0100,ASIAN18,0,3,3,1,2
0100,AMINDIAN18,1,3,2,2,3
0100,PISLAND18,0,0,0,0,0
0100,OTHER18,0,0,0,0,0
0100,OTHERMLT18,8,20,12,13,18
0101,PERSONS,2331,2071,-260,2227,2123
0101,WHITE,57,85,28,68,79
0101,BLACK,2187,1774,-413,2022,1857
0101,HISPANIC,75,143,68,102,129
0101,ASIAN,1,1,0,1,1
0101,AMINDIAN,4,4,0,4,4
0101,PISLAND,1,1,0,1,1
0101,OTHER,0,3,3,1,2
0101,OTHERMLT,6,60,54,28,49
0101,PERSONS18,1341,1334,-7,1338,1335
0101,WHITE18,55,80,25,65,75
0101,BLACK18,1242,1133,-109,1198,1155
0101,HISPANIC18,40,83,43,57,74
0101,ASIAN18,0,1,1,0,1
0101,AMINDIAN18,1,4,3,2,3
0101,PISLAND18,1,1,0,1,1
0101,OTHER18,0,3,3,1,2
0101,OTHERMLT18,2,29,27,13,24
0102,PERSONS,1069,1110,41,1085,1102
0102,WHITE,798,846,48,817,836
0102,BLACK,127,108,-19,119,112
0102,HISPANIC,99,97,-2,98,97
0102,ASIAN,21,7,-14,15,10
0102,AMINDIAN,10,8,-2,9,8
0102,PISLAND,0,0,0,0,0
0102,OTHER,5,1,-4,3,2
0102,OTHERMLT,9,43,34,23,36
0102,PERSONS18,863,962,99,903,942
0102,WHITE18,689,778,89,725,760
0102,BLACK18,79,76,-3,78,77
0102,HISPANIC18,56,67,11,60,65
0102,ASIAN18,21,7,-14,15,10
0102,AMINDIAN18,8,7,-1,8,7
0102,PISLAND18,0,0,0,0,0
0102,OTHER18,4,1,-3,3,2
0102,OTHERMLT18,6,26,20,14,22
0103,PERSONS,2438,2194,-244,2340,2243
0103,WHITE,1070,1347,277,1181,1292
0103,BLACK,710,344,-366,564,417
0103,HISPANIC,554,372,-182,481,408
0103,ASIAN,26,26,0,26,26
0103,AMINDIAN,37,17,-20,29,21
0103,PISLAND,0,1,1,0,1
0103,OTHER,20,9,-11,16,11
0103,OTHERMLT,21,78,57,44,67
0103,PERSONS18,1762,1825,63,1787,1812
0103,WHITE18,972,1247,275,1082,1192
0103,BLACK18,389,239,-150,329,269
0103,HISPANIC18,331,256,-75,301,271
0103,ASIAN18,21,21,0,21,21
0103,AMINDIAN18,25,16,-9,21,18
0103,PISLAND18,0,1,1,0,1
0103,OTHER18,12,4,-8,9,6
0103,OTHERMLT18,12,41,29,24,35
0104,PERSONS,1176,1088,-88,1141,1106
0104,WHITE,63,78,15,69,75
0104,BLACK,946,812,-134,892,839
0104,HISPANIC,144,145,1,144,145
0104,ASIAN,1,1,0,1,1
0104,AMINDIAN,12,7,-5,10,8
0104,PISLAND,0,0,0,0,0
0104,OTHER,0,0,0,0,0
0104,OTHERMLT,10,45,35,24,38
0104,PERSONS18,728,719,-9,724,721
0104,WHITE18,58,70,12,63,68
0104,BLACK18,553,528,-25,543,533
0104,HISPANIC18,100,98,-2,99,98
0104,ASIAN18,1,1,0,1,1
0104,AMINDIAN18,8,4,-4,6,5
0104,PISLAND18,0,0,0,0,0
0104,OTHER18,0,0,0,0,0
0104,OTHERMLT18,8,18,10,12,16
0105,PERSONS,2179,1929,-250,2079,1979
0105,WHITE,948,1201,253,1049,1150
0105,BLACK,699,338,-361,555,410
0105,HISPANIC,460,300,-160,396,332
0105,ASIAN,10,18,8,13,16
0105,AMINDIAN,19,8,-11,15,10
0105,PISLAND,0,0,0,0,0
0105,OTHER,27,1,-26,17,6
0105,OTHERMLT,16,63,47,35,54
0105,PERSONS18,1556,1620,64,1582,1607
0105,WHITE18,850,1113,263,955,1060
0105,BLACK18,379,231,-148,320,261
0105,HISPANIC18,282,210,-72,253,224
0105,ASIAN18,9,18,9,13,16
0105,AMINDIAN18,14,6,-8,11,8
0105,PISLAND18,0,0,0,0,0
0105,OTHER18,14,1,-13,9,4
0105,OTHERMLT18,9,41,32,22,35
0113,PERSONS,2506,2369,-137,2451,2396
0113,WHITE,507,253,-254,405,304
0113,BLACK,1620,1804,184,1694,1767
0113,HISPANIC,79,96,17,86,93
0113,ASIAN,252,153,-99,212,173
0113,AMINDIAN,17,14,-3,16,15
0113,PISLAND,0,0,0,0,0
0113,OTHER,5,0,-5,3,1
0113,OTHERMLT,26,49,23,35,44
0113,PERSONS18,1599,1619,20,1607,1615
0113,WHITE18,443,236,-207,360,277
0113,BLACK18,971,1187,216,1057,1144
0113,HISPANIC18,54,66,12,59,64
0113,ASIAN18,105,99,-6,103,100
0113,AMINDIAN18,11,11,0,11,11
0113,PISLAND18,0,0,0,0,0
0113,OTHER18,4,0,-4,2,1
0113,OTHERMLT18,11,20,9,15,18
0114,PERSONS,1375,1395,20,1383,1391
0114,WHITE,276,121,-155,214,152
0114,BLACK,1008,1175,167,1075,1142
0114,HISPANIC,45,44,-1,45,44
0114,ASIAN,21,21,0,21,21
0114,AMINDIAN,7,6,-1,7,6
0114,PISLAND,0,1,1,0,1
0114,OTHER,2,3,1,2,3
0114,OTHERMLT,16,24,8,19,22
0114,PERSONS18,933,924,-9,929,926
0114,WHITE18,248,116,-132,195,142
0114,BLACK18,634,762,128,685,736
0114,HISPANIC18,20,25,5,22,24
0114,ASIAN18,13,10,-3,12,11
0114,AMINDIAN18,4,1,-3,3,2
0114,PISLAND18,0,1,1,0,1
0114,OTHER18,2,0,-2,1,0
0114,OTHERMLT18,12,9,-3,11,10
0115,PERSONS,2229,2091,-138,2174,2119
0115,WHITE,206,100,-106,164,121
0115,BLACK,1958,1893,-65,1932,1906
0115,HISPANIC,12,47,35,26,40
0115,ASIAN,29,15,-14,23,18
0115,AMINDIAN,7,4,-3,6,5
0115,PISLAND,1,0,-1,1,0
0115,OTHER,1,5,4,3,4
0115,OTHERMLT,15,27,12,20,25
0115,PERSONS18,1519,1431,-88,1484,1449
0115,WHITE18,192,89,-103,151,110
0115,BLACK18,1274,1287,13,1279,1284
0115,HISPANIC18,7,30,23,16,25
0115,ASIAN18,27,9,-18,20,13
0115,AMINDIAN18,6,4,-2,5,4
0115,PISLAND18,1,0,-1,1,0
0115,OTHER18,1,0,-1,1,0
0115,OTHERMLT18,11,12,1,11,12
0116,PERSONS,1547,1534,-13,1542,1537
0116,WHITE,47,30,-17,40,33
0116,BLACK,1457,1435,-22,1448,1439
0116,HISPANIC,21,23,2,22,23
0116,ASIAN,15,3,-12,10,5
0116,AMINDIAN,2,3,1,2,3
0116,PISLAND,0,0,0,0,0
0116,OTHER,1,0,-1,1,0
0116,OTHERMLT,4,40,36,18,33
0116,PERSONS18,854,910,56,876,899
0116,WHITE18,45,28,-17,38,31
0116,BLACK18,787,851,64,813,838
0116,HISPANIC18,10,11,1,10,11
0116,ASIAN18,7,3,-4,5,4
0116,AMINDIAN18,2,2,0,2,2
0116,PISLAND18,0,0,0,0,0
0116,OTHER18,1,0,-1,1,0
0116,OTHERMLT18,2,15,13,7,12
0117,PERSONS,2205,2012,-193,2128,2051
0117,WHITE,265,132,-133,212,159
0117,BLACK,1864,1782,-82,1831,1798
0117,HISPANIC,39,60,21,47,56
0117,ASIAN,18,3,-15,12,6
0117,AMINDIAN,3,2,-1,3,2
0117,PISLAND,1,0,-1,1,0
0117,OTHER,0,1,1,0,1
0117,OTHERMLT,15,32,17,22,29
0117,PERSONS18,1497,1462,-35,1483,1469
0117,WHITE18,231,123,-108,188,145
0117,BLACK18,1213,1277,64,1239,1264
0117,HISPANIC18,29,37,8,32,35
0117,ASIAN18,13,3,-10,9,5
0117,AMINDIAN18,2,1,-1,2,1
0117,PISLAND18,0,0,0,0,0
0117,OTHER18,0,1,1,0,1
0117,OTHERMLT18,9,20,11,13,18
0118,PERSONS,1495,1396,-99,1455,1416
0118,WHITE,313,274,-39,297,282
0118,BLACK,1067,1015,-52,1046,1025
0118,HISPANIC,43,43,0,43,43
0118,ASIAN,28,16,-12,23,18
0118,AMINDIAN,21,0,-21,13,4
0118,PISLAND,0,0,0,0,0
0118,OTHER,3,3,0,3,3
0118,OTHERMLT,20,45,25,30,40
0118,PERSONS18,995,969,-26,985,974
0118,WHITE18,275,203,-72,246,217
0118,BLACK18,656,707,51,676,697
0118,HISPANIC18,24,20,-4,22,21
0118,ASIAN18,15,12,-3,14,13
0118,AMINDIAN18,10,0,-10,6,2
0118,PISLAND18,0,0,0,0,0
0118,OTHER18,1,2,1,1,2
0118,OTHERMLT18,14,25,11,18,23
0119,PERSONS,1185,1100,-85,1151,1117
0119,WHITE,568,521,-47,549,530
0119,BLACK,547,500,-47,528,509
0119,HISPANIC,29,38,9,33,36
0119,ASIAN,20,8,-12,15,10
0119,AMINDIAN,7,2,-5,5,3
0119,PISLAND,1,0,-1,1,0
0119,OTHER,6,2,-4,4,3
0119,OTHERMLT,7,29,22,16,25
0119,PERSONS18,778,760,-18,771,764
0119,WHITE18,365,343,-22,356,347
0119,BLACK18,374,368,-6,372,369
0119,HISPANIC18,17,27,10,21,25
0119,ASIAN18,7,5,-2,6,5
0119,AMINDIAN18,6,2,-4,4,3
0119,PISLAND18,1,0,-1,1,0
0119,OTHER18,4,2,-2,3,2
0119,OTHERMLT18,4,13,9,8,11
0012,PERSONS,1769,1656,-113,1724,1679
0012,WHITE,28,36,8,31,34
0012,BLACK,1721,1553,-168,1654,1587
0012,HISPANIC,10,41,31,22,35
0012,ASIAN,0,0,0,0,0
0012,AMINDIAN,2,5,3,3,4
0012,PISLAND,0,0,0,0,0
0012,OTHER,0,1,1,0,1
0012,OTHERMLT,8,20,12,13,18
0012,PERSONS18,1199,1165,-34,1185,1172
0012,WHITE18,24,31,7,27,30
0012,BLACK18,1160,1096,-64,1134,1109
0012,HISPANIC18,8,21,13,13,18
0012,ASIAN18,0,0,0,0,0
0012,AMINDIAN18,2,3,1,2,3
0012,PISLAND18,0,0,0,0,0
0012,OTHER18,0,1,1,0,1
0012,OTHERMLT18,5,13,8,8,11
0120,PERSONS,1846,1811,-35,1832,1818
0120,WHITE,757,537,-220,669,581
0120,BLACK,986,1121,135,1040,1094
0120,HISPANIC,52,71,19,60,67
0120,ASIAN,22,17,-5,20,18
0120,AMINDIAN,8,6,-2,7,6
0120,PISLAND,0,0,0,0,0
0120,OTHER,8,8,0,8,8
0120,OTHERMLT,13,51,38,28,43
0120,PERSONS18,1323,1300,-23,1314,1305
0120,WHITE18,606,418,-188,531,456
0120,BLACK18,652,792,140,708,764
0120,HISPANIC18,38,43,5,40,42
0120,ASIAN18,12,12,0,12,12
0120,AMINDIAN18,4,6,2,5,6
0120,PISLAND18,0,0,0,0,0
0120,OTHER18,4,3,-1,4,3
0120,OTHERMLT18,7,26,19,15,22
0121,PERSONS,1219,1293,74,1249,1278
0121,WHITE,411,217,-194,333,256
0121,BLACK,697,924,227,788,879
0121,HISPANIC,48,58,10,52,56
0121,ASIAN,52,52,0,52,52
0121,AMINDIAN,2,4,2,3,4
0121,PISLAND,0,0,0,0,0
0121,OTHER,2,0,-2,1,0
0121,OTHERMLT,7,38,31,19,32
0121,PERSONS18,881,979,98,920,959
0121,WHITE18,363,186,-177,292,221
0121,BLACK18,449,699,250,549,649
0121,HISPANIC18,35,39,4,37,38
0121,ASIAN18,23,31,8,26,29
0121,AMINDIAN18,2,4,2,3,4
0121,PISLAND18,0,0,0,0,0
0121,OTHER18,2,0,-2,1,0
0121,OTHERMLT18,7,20,13,12,17
0122,PERSONS,1570,1427,-143,1513,1456
0122,WHITE,101,79,-22,92,83
0122,BLACK,1420,1283,-137,1365,1310
0122,HISPANIC,29,34,5,31,33
0122,ASIAN,2,2,0,2,2
0122,AMINDIAN,3,2,-1,3,2
0122,PISLAND,1,0,-1,1,0
0122,OTHER,3,1,-2,2,1
0122,OTHERMLT,11,26,15,17,23
0122,PERSONS18,961,940,-21,953,944
0122,WHITE18,96,71,-25,86,76
0122,BLACK18,837,836,-1,837,836
0122,HISPANIC18,15,21,6,17,20
0122,ASIAN18,2,2,0,2,2
0122,AMINDIAN18,2,0,-2,1,0
0122,PISLAND18,1,0,-1,1,0
0122,OTHER18,0,1,1,0,1
0122,OTHERMLT18,8,9,1,8,9
0123,PERSONS,1917,1628,-289,1801,1686
0123,WHITE,413,263,-150,353,293
0123,BLACK,1443,1259,-184,1369,1296
0123,HISPANIC,27,48,21,35,44
0123,ASIAN,3,11,8,6,9
0123,AMINDIAN,6,9,3,7,8
0123,PISLAND,0,0,0,0,0
0123,OTHER,3,1,-2,2,1
0123,OTHERMLT,22,37,15,28,34
0123,PERSONS18,1210,1131,-79,1178,1147
0123,WHITE18,309,194,-115,263,217
0123,BLACK18,871,879,8,874,877
0123,HISPANIC18,15,26,11,19,24
0123,ASIAN18,1,9,8,4,7
0123,AMINDIAN18,4,6,2,5,6
0123,PISLAND18,0,0,0,0,0
0123,OTHER18,2,0,-2,1,0
0123,OTHERMLT18,8,17,9,12,15
0124,PERSONS,1717,1660,-57,1694,1671
0124,WHITE,537,299,-238,442,347
0124,BLACK,1037,1213,176,1107,1178
0124,HISPANIC,61,77,16,67,74
0124,ASIAN,43,27,-16,37,30
0124,AMINDIAN,4,6,2,5,6
0124,PISLAND,0,0,0,0,0
0124,OTHER,6,4,-2,5,4
0124,OTHERMLT,29,34,5,31,33
0124,PERSONS18,1124,1152,28,1135,1146
0124,WHITE18,443,262,-181,371,298
0124,BLACK18,609,811,202,690,771
0124,HISPANIC18,30,40,10,34,38
0124,ASIAN18,20,15,-5,18,16
0124,AMINDIAN18,3,3,0,3,3
0124,PISLAND18,0,0,0,0,0
0124,OTHER18,6,3,-3,5,4
0124,OTHERMLT18,13,18,5,15,17
0125,PERSONS,1821,1775,-46,1803,1784
0125,WHITE,883,525,-358,740,597
0125,BLACK,738,1012,274,848,957
0125,HISPANIC,103,100,-3,102,101
0125,ASIAN,59,55,-4,57,56
0125,AMINDIAN,10,11,1,10,11
0125,PISLAND,1,0,-1,1,0
0125,OTHER,5,2,-3,4,3
0125,OTHERMLT,22,70,48,41,60
0125,PERSONS18,1307,1292,-15,1301,1295
0125,WHITE18,735,455,-280,623,511
0125,BLACK18,455,702,247,554,653
0125,HISPANIC18,57,63,6,59,62
0125,ASIAN18,37,35,-2,36,35
0125,AMINDIAN18,7,3,-4,5,4
0125,PISLAND18,1,0,-1,1,0
0125,OTHER18,2,1,-1,2,1
0125,OTHERMLT18,13,33,20,21,29
0126,PERSONS,1937,1852,-85,1903,1869
0126,WHITE,897,654,-243,800,703
0126,BLACK,811,944,133,864,917
0126,HISPANIC,69,119,50,89,109
0126,ASIAN,111,57,-54,89,68
0126,AMINDIAN,16,15,-1,16,15
0126,PISLAND,2,0,-2,1,0
0126,OTHER,19,2,-17,12,5
0126,OTHERMLT,12,61,49,32,51
0126,PERSONS18,1276,1296,20,1284,1292
0126,WHITE18,712,562,-150,652,592
0126,BLACK18,452,577,125,502,552
0126,HISPANIC18,35,80,45,53,71
0126,ASIAN18,51,36,-15,45,39
0126,AMINDIAN18,13,10,-3,12,11
0126,PISLAND18,2,0,-2,1,0
0126,OTHER18,7,2,-5,5,3
0126,OTHERMLT18,4,29,25,14,24
0127,PERSONS,2177,2065,-112,2132,2087
0127,WHITE,475,229,-246,377,278
0127,BLACK,1500,1646,146,1558,1617
0127,HISPANIC,50,92,42,67,84
0127,ASIAN,111,49,-62,86,61
0127,AMINDIAN,13,7,-6,11,8
0127,PISLAND,1,0,-1,1,0
0127,OTHER,4,1,-3,3,2
0127,OTHERMLT,23,41,18,30,37
0127,PERSONS18,1340,1362,22,1349,1358
0127,WHITE18,402,211,-191,326,249
0127,BLACK18,832,1039,207,915,998
0127,HISPANIC18,24,52,28,35,46
0127,ASIAN18,60,35,-25,50,40
0127,AMINDIAN18,10,5,-5,8,6
0127,PISLAND18,1,0,-1,1,0
0127,OTHER18,2,1,-1,2,1
0127,OTHERMLT18,9,19,10,13,17
0128,PERSONS,2742,2446,-296,2624,2505
0128,WHITE,284,179,-105,242,200
0128,BLACK,2287,2096,-191,2211,2134
0128,HISPANIC,55,60,5,57,59
0128,ASIAN,67,45,-22,58,49
0128,AMINDIAN,20,8,-12,15,10
0128,PISLAND,0,0,0,0,0
0128,OTHER,9,2,-7,6,3
0128,OTHERMLT,20,56,36,34,49
0128,PERSONS18,1629,1565,-64,1603,1578
0128,WHITE18,254,154,-100,214,174
0128,BLACK18,1285,1318,33,1298,1311
0128,HISPANIC18,32,35,3,33,34
0128,ASIAN18,35,29,-6,33,30
0128,AMINDIAN18,11,5,-6,9,6
0128,PISLAND18,0,0,0,0,0
0128,OTHER18,3,2,-1,3,2
0128,OTHERMLT18,9,22,13,14,19
0014,PERSONS,1553,1560,7,1556,1559
0014,WHITE,41,31,-10,37,33
0014,BLACK,1458,1464,6,1460,1463
0014,HISPANIC,24,29,5,26,28
0014,ASIAN,15,11,-4,13,12
0014,AMINDIAN,4,1,-3,3,2
0014,PISLAND,0,0,0,0,0
0014,OTHER,4,2,-2,3,2
0014,OTHERMLT,7,22,15,13,19
0014,PERSONS18,1070,1051,-19,1062,1055
0014,WHITE18,38,26,-12,33,28
0014,BLACK18,1000,987,-13,995,990
0014,HISPANIC18,13,15,2,14,15
0014,ASIAN18,8,10,2,9,10
0014,AMINDIAN18,3,0,-3,2,1
0014,PISLAND18,0,0,0,0,0
0014,OTHER18,2,2,0,2,2
0014,OTHERMLT18,6,11,5,8,10
0140,PERSONS,3099,3344,245,3197,3295
0140,WHITE,1143,514,-629,891,640
0140,BLACK,141,238,97,180,219
0140,HISPANIC,1585,2441,856,1927,2270
0140,ASIAN,94,61,-33,81,68
0140,AMINDIAN,89,32,-57,66,43
0140,PISLAND,4,0,-4,2,1
0140,OTHER,26,0,-26,16,5
0140,OTHERMLT,17,58,41,33,50
0140,PERSONS18,2019,2085,66,2045,2072
0140,WHITE18,906,433,-473,717,528
0140,BLACK18,67,128,61,91,116
0140,HISPANIC18,918,1433,515,1124,1330
0140,ASIAN18,45,43,-2,44,43
0140,AMINDIAN18,59,26,-33,46,33
0140,PISLAND18,4,0,-4,2,1
0140,OTHER18,15,0,-15,9,3
0140,OTHERMLT18,5,22,17,12,19
0141,PERSONS,2350,2546,196,2428,2507
0141,WHITE,906,456,-450,726,546
0141,BLACK,97,114,17,104,111
0141,HISPANIC,1191,1882,691,1467,1744
0141,ASIAN,84,30,-54,62,41
0141,AMINDIAN,59,36,-23,50,41
0141,PISLAND,0,0,0,0,0
0141,OTHER,8,0,-8,5,2
0141,OTHERMLT,5,28,23,14,23
0141,PERSONS18,1536,1630,94,1574,1611
0141,WHITE18,722,394,-328,591,460
0141,BLACK18,45,77,32,58,71
0141,HISPANIC18,682,1103,421,850,1019
0141,ASIAN18,43,15,-28,32,21
0141,AMINDIAN18,35,25,-10,31,27
0141,PISLAND18,0,0,0,0,0
0141,OTHER18,5,0,-5,3,1
0141,OTHERMLT18,4,16,12,9,14
0142,PERSONS,3381,3772,391,3537,3694
0142,WHITE,1681,742,-939,1305,930
0142,BLACK,162,265,103,203,244
0142,HISPANIC,1387,2625,1238,1882,2377
0142,ASIAN,62,27,-35,48,34
0142,AMINDIAN,75,38,-37,60,45
0142,PISLAND,3,2,-1,3,2
0142,OTHER,7,5,-2,6,5
0142,OTHERMLT,4,68,64,30,55
0142,PERSONS18,2240,2432,192,2317,2394
0142,WHITE18,1260,648,-612,1015,770
0142,BLACK18,75,142,67,102,129
0142,HISPANIC18,806,1567,761,1110,1415
0142,ASIAN18,39,17,-22,30,21
0142,AMINDIAN18,52,33,-19,44,37
0142,PISLAND18,3,0,-3,2,1
0142,OTHER18,2,0,-2,1,0
0142,OTHERMLT18,3,25,22,12,21
0143,PERSONS,1052,1284,232,1145,1238
0143,WHITE,754,417,-337,619,484
0143,BLACK,24,39,15,30,36
0143,HISPANIC,222,781,559,446,669
0143,ASIAN,19,15,-4,17,16
0143,AMINDIAN,27,15,-12,22,17
0143,PISLAND,0,2,2,1,2
0143,OTHER,2,0,-2,1,0
0143,OTHERMLT,4,15,11,8,13
0143,PERSONS18,788,889,101,828,869
0143,WHITE18,610,370,-240,514,418
0143,BLACK18,12,23,11,16,21
0143,HISPANIC18,128,465,337,263,398
0143,ASIAN18,15,14,-1,15,14
0143,AMINDIAN18,20,10,-10,16,12
0143,PISLAND18,0,1,1,0,1
0143,OTHER18,1,0,-1,1,0
0143,OTHERMLT18,2,6,4,4,5
0144,PERSONS,1912,2098,186,1986,2061
0144,WHITE,1407,958,-449,1227,1048
0144,BLACK,57,72,15,63,69
0144,HISPANIC,321,948,627,572,823
0144,ASIAN,73,71,-2,72,71
0144,AMINDIAN,41,18,-23,32,23
0144,PISLAND,1,0,-1,1,0
0144,OTHER,7,3,-4,5,4
0144,OTHERMLT,5,28,23,14,23
0144,PERSONS18,1465,1515,50,1485,1505
0144,WHITE18,1143,826,-317,1016,889
0144,BLACK18,38,51,13,43,48
0144,HISPANIC18,200,559,359,344,487
0144,ASIAN18,48,51,3,49,50
0144,AMINDIAN18,26,14,-12,21,16
0144,PISLAND18,1,0,-1,1,0
0144,OTHER18,6,1,-5,4,2
0144,OTHERMLT18,3,13,10,7,11
0145,PERSONS,1635,1727,92,1672,1709
0145,WHITE,1459,1213,-246,1361,1262
0145,BLACK,20,73,53,41,62
0145,HISPANIC,119,352,233,212,305
0145,ASIAN,12,48,36,26,41
0145,AMINDIAN,21,12,-9,17,14
0145,PISLAND,1,0,-1,1,0
0145,OTHER,3,2,-1,3,2
0145,OTHERMLT,0,27,27,11,22
0145,PERSONS18,1296,1315,19,1304,1311
0145,WHITE18,1189,987,-202,1108,1027
0145,BLACK18,12,47,35,26,40
0145,HISPANIC18,77,218,141,133,190
0145,ASIAN18,6,38,32,19,32
0145,AMINDIAN18,11,9,-2,10,9
0145,PISLAND18,0,0,0,0,0
0145,OTHER18,1,2,1,1,2
0145,OTHERMLT18,0,14,14,6,11
0146,PERSONS,1523,1616,93,1560,1597
0146,WHITE,1385,1288,-97,1346,1307
0146,BLACK,20,28,8,23,26
0146,HISPANIC,71,241,170,139,207
0146,ASIAN,38,32,-6,36,33
0146,AMINDIAN,6,5,-1,6,5
0146,PISLAND,0,0,0,0,0
0146,OTHER,3,1,-2,2,1
0146,OTHERMLT,0,21,21,8,17
0146,PERSONS18,1206,1225,19,1214,1221
0146,WHITE18,1123,1026,-97,1084,1045
0146,BLACK18,9,19,10,13,17
0146,HISPANIC18,38,144,106,80,123
0146,ASIAN18,27,21,-6,25,22
0146,AMINDIAN18,6,5,-1,6,5
0146,PISLAND18,0,0,0,0,0
0146,OTHER18,3,1,-2,2,1
0146,OTHERMLT18,0,9,9,4,7
0147,PERSONS,2076,2069,-7,2073,2070
0147,WHITE,800,475,-325,670,540
0147,BLACK,1146,1431,285,1260,1374
0147,HISPANIC,70,73,3,71,72
0147,ASIAN,38,40,2,39,40
0147,AMINDIAN,9,7,-2,8,7
0147,PISLAND,0,0,0,0,0
0147,OTHER,6,0,-6,4,1
0147,OTHERMLT,7,43,36,21,36
0147,PERSONS18,1412,1388,-24,1402,1393
0147,WHITE18,659,405,-254,557,456
0147,BLACK18,683,886,203,764,845
0147,HISPANIC18,39,41,2,40,41
0147,ASIAN18,21,29,8,24,27
0147,AMINDIAN18,5,4,-1,5,4
0147,PISLAND18,0,0,0,0,0
0147,OTHER18,2,0,-2,1,0
0147,OTHERMLT18,3,23,20,11,19
0148,PERSONS,1500,1484,-16,1494,1487
0148,WHITE,995,787,-208,912,829
0148,BLACK,408,535,127,459,510
0148,HISPANIC,42,41,-1,42,41
0148,ASIAN,30,71,41,46,63
0148,AMINDIAN,13,16,3,14,15
0148,PISLAND,0,0,0,0,0
0148,OTHER,7,1,-6,5,2
0148,OTHERMLT,5,33,28,16,27
0148,PERSONS18,1176,1138,-38,1161,1146
0148,WHITE18,815,649,-166,749,682
0148,BLACK18,306,395,89,342,377
0148,HISPANIC18,25,32,7,28,31
0148,ASIAN18,19,37,18,26,33
0148,AMINDIAN18,9,11,2,10,11
0148,PISLAND18,0,0,0,0,0
0148,OTHER18,0,1,1,0,1
0148,OTHERMLT18,2,13,11,6,11
0149,PERSONS,2893,2834,-59,2869,2846
0149,WHITE,1576,806,-770,1268,960
0149,BLACK,1162,1830,668,1429,1696
0149,HISPANIC,76,81,5,78,80
0149,ASIAN,25,26,1,25,26
0149,AMINDIAN,18,4,-14,12,7
0149,PISLAND,1,1,0,1,1
0149,OTHER,16,0,-16,10,3
0149,OTHERMLT,19,86,67,46,73
0149,PERSONS18,2303,2211,-92,2266,2229
0149,WHITE18,1436,777,-659,1172,909
0149,BLACK18,773,1322,549,993,1212
0149,HISPANIC18,45,48,3,46,47
0149,ASIAN18,22,23,1,22,23
0149,AMINDIAN18,9,3,-6,7,4
0149,PISLAND18,1,1,0,1,1
0149,OTHER18,3,0,-3,2,1
0149,OTHERMLT18,14,37,23,23,32
0015,PERSONS,3434,3101,-333,3301,3168
0015,WHITE,369,174,-195,291,213
0015,BLACK,2898,2720,-178,2827,2756
0015,HISPANIC,75,85,10,79,83
0015,ASIAN,44,22,-22,35,26
0015,AMINDIAN,20,16,-4,18,17
0015,PISLAND,0,0,0,0,0
0015,OTHER,7,6,-1,7,6
0015,OTHERMLT,21,78,57,44,67
0015,PERSONS18,2119,2005,-114,2073,2028
0015,WHITE18,321,162,-159,257,194
0015,BLACK18,1713,1743,30,1725,1737
0015,HISPANIC18,42,49,7,45,48
0015,ASIAN18,20,14,-6,18,15
0015,AMINDIAN18,14,7,-7,11,8
0015,PISLAND18,0,0,0,0,0
0015,OTHER18,0,1,1,0,1
0015,OTHERMLT18,9,29,20,17,25
0150,PERSONS,2013,1955,-58,1990,1967
0150,WHITE,569,297,-272,460,351
0150,BLACK,1317,1518,201,1397,1478
0150,HISPANIC,71,57,-14,65,60
0150,ASIAN,11,20,9,15,18
0150,AMINDIAN,13,8,-5,11,9
0150,PISLAND,0,2,2,1,2
0150,OTHER,10,0,-10,6,2
0150,OTHERMLT,22,53,31,34,47
0150,PERSONS18,1220,1119,-101,1180,1139
0150,WHITE18,465,258,-207,382,299
0150,BLACK18,688,794,106,730,773
0150,HISPANIC18,37,22,-15,31,25
0150,ASIAN18,7,14,7,10,13
0150,AMINDIAN18,7,5,-2,6,5
0150,PISLAND18,0,2,2,1,2
0150,OTHER18,3,0,-3,2,1
0150,OTHERMLT18,13,24,11,17,22
0151,PERSONS,1290,1268,-22,1281,1272
0151,WHITE,664,423,-241,568,471
0151,BLACK,531,663,132,584,637
0151,HISPANIC,48,68,20,56,64
0151,ASIAN,25,64,39,41,56
0151,AMINDIAN,10,2,-8,7,4
0151,PISLAND,2,0,-2,1,0
0151,OTHER,4,9,5,6,8
0151,OTHERMLT,6,39,33,19,32
0151,PERSONS18,887,909,22,896,905
0151,WHITE18,524,365,-159,460,397
0151,BLACK18,307,435,128,358,409
0151,HISPANIC18,28,37,9,32,35
0151,ASIAN18,17,44,27,28,39
0151,AMINDIAN18,4,2,-2,3,2
0151,PISLAND18,2,0,-2,1,0
0151,OTHER18,3,2,-1,3,2
0151,OTHERMLT18,2,24,22,11,20
0152,PERSONS,3195,3305,110,3239,3283
0152,WHITE,1271,635,-636,1017,762
0152,BLACK,1687,2224,537,1902,2117
0152,HISPANIC,93,119,26,103,114
0152,ASIAN,83,168,85,117,151
0152,AMINDIAN,15,18,3,16,17
0152,PISLAND,1,0,-1,1,0
0152,OTHER,16,8,-8,13,10
0152,OTHERMLT,29,133,104,71,112
0152,PERSONS18,2251,2313,62,2276,2301
0152,WHITE18,1074,582,-492,877,680
0152,BLACK18,1045,1505,460,1229,1413
0152,HISPANIC18,55,69,14,61,66
0152,ASIAN18,40,90,50,60,80
0152,AMINDIAN18,9,13,4,11,12
0152,PISLAND18,1,0,-1,1,0
0152,OTHER18,11,5,-6,9,6
0152,OTHERMLT18,16,49,33,29,42
0153,PERSONS,1160,1027,-133,1107,1054
0153,WHITE,564,326,-238,469,374
0153,BLACK,493,533,40,509,525
0153,HISPANIC,40,21,-19,32,25
0153,ASIAN,36,101,65,62,88
0153,AMINDIAN,4,2,-2,3,2
0153,PISLAND,1,1,0,1,1
0153,OTHER,9,1,-8,6,3
0153,OTHERMLT,13,42,29,25,36
0153,PERSONS18,788,773,-15,782,776
0153,WHITE18,441,286,-155,379,317
0153,BLACK18,294,395,101,334,375
0153,HISPANIC18,20,15,-5,18,16
0153,ASIAN18,20,57,37,35,50
0153,AMINDIAN18,3,2,-1,3,2
0153,PISLAND18,1,1,0,1,1
0153,OTHER18,2,1,-1,2,1
0153,OTHERMLT18,7,16,9,11,14
0190,PERSONS,2172,2263,91,2208,2245
0190,WHITE,1978,1819,-159,1914,1851
0190,BLACK,20,93,73,49,78
0190,HISPANIC,116,256,140,172,228
0190,ASIAN,19,41,22,28,37
0190,AMINDIAN,24,11,-13,19,14
0190,PISLAND,0,0,0,0,0
0190,OTHER,15,2,-13,10,5
0190,OTHERMLT,0,41,41,16,33
0190,PERSONS18,1873,1857,-16,1867,1860
0190,WHITE18,1746,1580,-166,1680,1613
0190,BLACK18,10,59,49,30,49
0190,HISPANIC18,76,159,83,109,142
0190,ASIAN18,13,32,19,21,28
0190,AMINDIAN18,18,7,-11,14,9
0190,PISLAND18,0,0,0,0,0
0190,OTHER18,10,1,-9,6,3
0190,OTHERMLT18,0,19,19,8,15
0191,PERSONS,1512,1537,25,1522,1532
0191,WHITE,1420,1336,-84,1386,1353
0191,BLACK,11,30,19,19,26
0191,HISPANIC,55,111,56,77,100
0191,ASIAN,16,26,10,20,24
0191,AMINDIAN,9,12,3,10,11
0191,PISLAND,0,0,0,0,0
0191,OTHER,1,1,0,1,1
0191,OTHERMLT,0,21,21,8,17
0191,PERSONS18,1254,1197,-57,1231,1208
0191,WHITE18,1196,1072,-124,1146,1097
0191,BLACK18,3,15,12,8,13
0191,HISPANIC18,33,67,34,47,60
0191,ASIAN18,13,23,10,17,21
0191,AMINDIAN18,8,8,0,8,8
0191,PISLAND18,0,0,0,0,0
0191,OTHER18,1,1,0,1,1
0191,OTHERMLT18,0,11,11,4,9
0192,PERSONS,2627,2677,50,2647,2667
0192,WHITE,2419,2236,-183,2346,2273
0192,BLACK,33,65,32,46,59
0192,HISPANIC,102,279,177,173,244
0192,ASIAN,56,56,0,56,56
0192,AMINDIAN,7,11,4,9,10
0192,PISLAND,0,0,0,0,0
0192,OTHER,7,2,-5,5,3
0192,OTHERMLT,3,28,25,13,23
0192,PERSONS18,2217,2190,-27,2206,2195
0192,WHITE18,2089,1915,-174,2019,1950
0192,BLACK18,21,54,33,34,47
0192,HISPANIC18,63,159,96,101,140
0192,ASIAN18,34,43,9,38,41
0192,AMINDIAN18,5,7,2,6,7
0192,PISLAND18,0,0,0,0,0
0192,OTHER18,4,1,-3,3,2
0192,OTHERMLT18,1,11,10,5,9
0193,PERSONS,1993,2019,26,2003,2014
0193,WHITE,1810,1620,-190,1734,1658
0193,BLACK,28,69,41,44,61
0193,HISPANIC,100,240,140,156,212
0193,ASIAN,21,18,-3,20,19
0193,AMINDIAN,11,20,9,15,18
0193,PISLAND,0,4,4,2,3
0193,OTHER,9,5,-4,7,6
0193,OTHERMLT,14,43,29,26,37
0193,PERSONS18,1503,1455,-48,1484,1465
0193,WHITE18,1414,1244,-170,1346,1278
0193,BLACK18,11,42,31,23,36
0193,HISPANIC18,50,133,83,83,116
0193,ASIAN18,16,9,-7,13,10
0193,AMINDIAN18,5,13,8,8,11
0193,PISLAND18,0,2,2,1,2
0193,OTHER18,2,1,-1,2,1
0193,OTHERMLT18,5,11,6,7,10
0194,PERSONS,1218,1199,-19,1210,1203
0194,WHITE,1113,1023,-90,1077,1041
0194,BLACK,6,15,9,10,13
0194,HISPANIC,57,100,43,74,91
0194,ASIAN,24,25,1,24,25
0194,AMINDIAN,10,9,-1,10,9
0194,PISLAND,0,0,0,0,0
0194,OTHER,3,0,-3,2,1
0194,OTHERMLT,5,27,22,14,23
0194,PERSONS18,945,912,-33,932,919
0194,WHITE18,881,814,-67,854,827
0194,BLACK18,4,7,3,5,6
0194,HISPANIC18,33,49,16,39,46
0194,ASIAN18,15,22,7,18,21
0194,AMINDIAN18,10,9,-1,10,9
0194,PISLAND18,0,0,0,0,0
0194,OTHER18,1,0,-1,1,0
0194,OTHERMLT18,1,11,10,5,9
0195,PERSONS,1197,1204,7,1200,1203
0195,WHITE,1103,965,-138,1048,993
0195,BLACK,13,32,19,21,28
0195,HISPANIC,52,146,94,90,127
0195,ASIAN,11,15,4,13,14
0195,AMINDIAN,11,11,0,11,11
0195,PISLAND,0,0,0,0,0
0195,OTHER,6,4,-2,5,4
0195,OTHERMLT,1,31,30,13,25
0195,PERSONS18,905,901,-4,903,902
0195,WHITE18,859,763,-96,821,782
0195,BLACK18,5,23,18,12,19
0195,HISPANIC18,23,87,64,49,74
0195,ASIAN18,6,11,5,8,10
0195,AMINDIAN18,6,8,2,7,8
0195,PISLAND18,0,0,0,0,0
0195,OTHER18,6,2,-4,4,3
0195,OTHERMLT18,0,7,7,3,6
0196,PERSONS,2882,2969,87,2917,2952
0196,WHITE,2484,2162,-322,2355,2226
0196,BLACK,89,142,53,110,131
0196,HISPANIC,168,442,274,278,387
0196,ASIAN,90,94,4,92,93
0196,AMINDIAN,30,34,4,32,33
0196,PISLAND,5,0,-5,3,1
0196,OTHER,2,5,3,3,4
0196,OTHERMLT,14,90,76,44,75
0196,PERSONS18,2248,2249,1,2248,2249
0196,WHITE18,1992,1758,-234,1898,1805
0196,BLACK18,51,82,31,63,76
0196,HISPANIC18,108,259,151,168,229
0196,ASIAN18,70,76,6,72,75
0196,AMINDIAN18,19,24,5,21,23
0196,PISLAND18,2,0,-2,1,0
0196,OTHER18,2,3,1,2,3
0196,OTHERMLT18,4,47,43,21,38
0157,PERSONS,2381,2301,-80,2349,2317
0157,WHITE,729,400,-329,597,466
0157,BLACK,1484,1706,222,1573,1662
0157,HISPANIC,97,96,-1,97,96
0157,ASIAN,34,26,-8,31,28
0157,AMINDIAN,8,14,6,10,13
0157,PISLAND,0,0,0,0,0
0157,OTHER,13,2,-11,9,4
0157,OTHERMLT,16,57,41,32,49
0157,PERSONS18,1608,1563,-45,1590,1572
0157,WHITE18,631,347,-284,517,404
0157,BLACK18,879,1118,239,975,1070
0157,HISPANIC18,59,55,-4,57,56
0157,ASIAN18,15,15,0,15,15
0157,AMINDIAN18,6,8,2,7,8
0157,PISLAND18,0,0,0,0,0
0157,OTHER18,11,2,-9,7,4
0157,OTHERMLT18,7,18,11,11,16
0158,PERSONS,1995,2010,15,2001,2007
0158,WHITE,689,306,-383,536,383
0158,BLACK,1168,1510,342,1305,1442
0158,HISPANIC,66,69,3,67,68
0158,ASIAN,39,36,-3,38,37
0158,AMINDIAN,21,12,-9,17,14
0158,PISLAND,0,0,0,0,0
0158,OTHER,0,2,2,1,2
0158,OTHERMLT,12,75,63,37,62
0158,PERSONS18,1308,1319,11,1312,1317
0158,WHITE18,562,283,-279,450,339
0158,BLACK18,663,933,270,771,879
0158,HISPANIC18,43,42,-1,43,42
0158,ASIAN18,17,19,2,18,19
0158,AMINDIAN18,18,10,-8,15,12
0158,PISLAND18,0,0,0,0,0
0158,OTHER18,0,2,2,1,2
0158,OTHERMLT18,5,30,25,15,25
0159,PERSONS,3032,2932,-100,2992,2952
0159,WHITE,654,335,-319,526,399
0159,BLACK,2026,2234,208,2109,2192
0159,HISPANIC,91,92,1,91,92
0159,ASIAN,187,181,-6,185,182
0159,AMINDIAN,28,10,-18,21,14
0159,PISLAND,0,10,10,4,8
0159,OTHER,17,4,-13,12,7
0159,OTHERMLT,29,66,37,44,59
0159,PERSONS18,1822,1822,0,1822,1822
0159,WHITE18,558,308,-250,458,358
0159,BLACK18,1096,1316,220,1184,1272
0159,HISPANIC18,54,56,2,55,56
0159,ASIAN18,82,99,17,89,96
0159,AMINDIAN18,14,10,-4,12,11
0159,PISLAND18,0,2,2,1,2
0159,OTHER18,3,2,-1,3,2
0159,OTHERMLT18,15,29,14,21,26
0016,PERSONS,1697,1566,-131,1645,1592
0016,WHITE,68,52,-16,62,55
0016,BLACK,1550,1420,-130,1498,1446
0016,HISPANIC,30,64,34,44,57
0016,ASIAN,25,18,-7,22,19
0016,AMINDIAN,3,2,-1,3,2
0016,PISLAND,0,0,0,0,0
0016,OTHER,0,1,1,0,1
0016,OTHERMLT,21,9,-12,16,11
0016,PERSONS18,1108,1104,-4,1106,1105
0016,WHITE18,58,49,-9,54,51
0016,BLACK18,1007,1005,-2,1006,1005
0016,HISPANIC18,17,28,11,21,26
0016,ASIAN18,14,13,-1,14,13
0016,AMINDIAN18,1,2,1,1,2
0016,PISLAND18,0,0,0,0,0
0016,OTHER18,0,0,0,0,0
0016,OTHERMLT18,11,7,-4,9,8
0160,PERSONS,2190,2025,-165,2124,2058
0160,WHITE,157,77,-80,125,93
0160,BLACK,1792,1314,-478,1601,1410
0160,HISPANIC,32,15,-17,25,18
0160,ASIAN,187,572,385,341,495
0160,AMINDIAN,6,4,-2,5,4
0160,PISLAND,0,0,0,0,0
0160,OTHER,2,2,0,2,2
0160,OTHERMLT,14,41,27,25,36
0160,PERSONS18,1050,1146,96,1088,1127
0160,WHITE18,126,67,-59,102,79
0160,BLACK18,819,760,-59,795,772
0160,HISPANIC18,20,8,-12,15,10
0160,ASIAN18,74,292,218,161,248
0160,AMINDIAN18,3,3,0,3,3
0160,PISLAND18,0,0,0,0,0
0160,OTHER18,1,2,1,1,2
0160,OTHERMLT18,7,14,7,10,13
0161,PERSONS,1602,1491,-111,1558,1513
0161,WHITE,253,115,-138,198,143
0161,BLACK,1279,1277,-2,1278,1277
0161,HISPANIC,44,64,20,52,60
0161,ASIAN,11,6,-5,9,7
0161,AMINDIAN,2,2,0,2,2
0161,PISLAND,0,0,0,0,0
0161,OTHER,5,0,-5,3,1
0161,OTHERMLT,8,27,19,16,23
0161,PERSONS18,1057,1066,9,1061,1064
0161,WHITE18,216,108,-108,173,130
0161,BLACK18,799,901,102,840,881
0161,HISPANIC18,25,32,7,28,31
0161,ASIAN18,8,6,-2,7,6
0161,AMINDIAN18,2,2,0,2,2
0161,PISLAND18,0,0,0,0,0
0161,OTHER18,1,0,-1,1,0
0161,OTHERMLT18,6,17,11,10,15
0162,PERSONS,2242,2089,-153,2181,2120
0162,WHITE,478,206,-272,369,260
0162,BLACK,1632,1755,123,1681,1730
0162,HISPANIC,65,69,4,67,68
0162,ASIAN,35,1,-34,21,8
0162,AMINDIAN,17,12,-5,15,13
0162,PISLAND,1,1,0,1,1
0162,OTHER,5,5,0,5,5
0162,OTHERMLT,9,40,31,21,34
0162,PERSONS18,1401,1440,39,1417,1432
0162,WHITE18,405,181,-224,315,226
0162,BLACK18,928,1182,254,1030,1131
0162,HISPANIC18,36,44,8,39,42
0162,ASIAN18,13,1,-12,8,3
0162,AMINDIAN18,13,9,-4,11,10
0162,PISLAND18,1,1,0,1,1
0162,OTHER18,1,3,2,2,3
0162,OTHERMLT18,4,19,15,10,16
0163,PERSONS,1462,1364,-98,1423,1384
0163,WHITE,346,154,-192,269,192
0163,BLACK,1033,1102,69,1061,1088
0163,HISPANIC,51,66,15,57,63
0163,ASIAN,11,1,-10,7,3
0163,AMINDIAN,9,6,-3,8,7
0163,PISLAND,1,0,-1,1,0
0163,OTHER,2,0,-2,1,0
0163,OTHERMLT,9,35,26,19,30
0163,PERSONS18,981,914,-67,954,927
0163,WHITE18,309,140,-169,241,174
0163,BLACK18,626,713,87,661,696
0163,HISPANIC18,26,38,12,31,36
0163,ASIAN18,6,1,-5,4,2
0163,AMINDIAN18,7,4,-3,6,5
0163,PISLAND18,0,0,0,0,0
0163,OTHER18,0,0,0,0,0
0163,OTHERMLT18,7,18,11,11,16
0164,PERSONS,1893,1552,-341,1757,1620
0164,WHITE,24,13,-11,20,15
0164,BLACK,1794,1473,-321,1666,1537
0164,HISPANIC,37,51,14,43,48
0164,ASIAN,0,0,0,0,0
0164,AMINDIAN,17,4,-13,12,7
0164,PISLAND,2,0,-2,1,0
0164,OTHER,0,0,0,0,0
0164,OTHERMLT,19,11,-8,16,13
0164,PERSONS18,1161,1015,-146,1103,1044
0164,WHITE18,16,12,-4,14,13
0164,BLACK18,1102,966,-136,1048,993
0164,HISPANIC18,22,26,4,24,25
0164,ASIAN18,0,0,0,0,0
0164,AMINDIAN18,10,2,-8,7,4
0164,PISLAND18,0,0,0,0,0
0164,OTHER18,0,0,0,0,0
0164,OTHERMLT18,11,9,-2,10,9
0165,PERSONS,1898,1648,-250,1798,1698
0165,WHITE,24,14,-10,20,16
0165,BLACK,1789,1542,-247,1690,1591
0165,HISPANIC,32,35,3,33,34
0165,ASIAN,21,10,-11,17,12
0165,AMINDIAN,7,1,-6,5,2
0165,PISLAND,0,0,0,0,0
0165,OTHER,3,1,-2,2,1
0165,OTHERMLT,22,45,23,31,40
0165,PERSONS18,1230,1175,-55,1208,1186
0165,WHITE18,22,14,-8,19,16
0165,BLACK18,1164,1114,-50,1144,1124
0165,HISPANIC18,17,20,3,18,19
0165,ASIAN18,12,5,-7,9,6
0165,AMINDIAN18,6,0,-6,4,1
0165,PISLAND18,0,0,0,0,0
0165,OTHER18,0,1,1,0,1
0165,OTHERMLT18,9,21,12,14,19
0166,PERSONS,1840,1767,-73,1811,1782
0166,WHITE,17,16,-1,17,16
0166,BLACK,1766,1681,-85,1732,1698
0166,HISPANIC,22,29,7,25,28
0166,ASIAN,18,4,-14,12,7
0166,AMINDIAN,4,1,-3,3,2
0166,PISLAND,2,1,-1,2,1
0166,OTHER,2,0,-2,1,0
0166,OTHERMLT,9,35,26,19,30
0166,PERSONS18,1163,1199,36,1177,1192
0166,WHITE18,12,13,1,12,13
0166,BLACK18,1119,1139,20,1127,1135
0166,HISPANIC18,9,17,8,12,15
0166,ASIAN18,12,4,-8,9,6
0166,AMINDIAN18,3,1,-2,2,1
0166,PISLAND18,0,1,1,0,1
0166,OTHER18,2,0,-2,1,0
0166,OTHERMLT18,6,24,18,13,20
0167,PERSONS,1661,1425,-236,1567,1472
0167,WHITE,10,10,0,10,10
0167,BLACK,1604,1375,-229,1512,1421
0167,HISPANIC,20,14,-6,18,15
0167,ASIAN,2,5,3,3,4
0167,AMINDIAN,5,2,-3,4,3
0167,PISLAND,0,0,0,0,0
0167,OTHER,0,1,1,0,1
0167,OTHERMLT,20,18,-2,19,18
0167,PERSONS18,1002,954,-48,983,964
0167,WHITE18,8,9,1,8,9
0167,BLACK18,970,921,-49,950,931
0167,HISPANIC18,7,7,0,7,7
0167,ASIAN18,1,3,2,2,3
0167,AMINDIAN18,4,2,-2,3,2
0167,PISLAND18,0,0,0,0,0
0167,OTHER18,0,0,0,0,0
0167,OTHERMLT18,12,12,0,12,12
0168,PERSONS,1787,1561,-226,1697,1606
0168,WHITE,23,32,9,27,30
0168,BLACK,1715,1462,-253,1614,1513
0168,HISPANIC,25,21,-4,23,22
0168,ASIAN,11,5,-6,9,6
0168,AMINDIAN,3,1,-2,2,1
0168,PISLAND,0,0,0,0,0
0168,OTHER,2,5,3,3,4
0168,OTHERMLT,8,35,27,19,30
0168,PERSONS18,1147,1105,-42,1130,1113
0168,WHITE18,18,26,8,21,24
0168,BLACK18,1104,1045,-59,1080,1057
0168,HISPANIC18,14,14,0,14,14
0168,ASIAN18,4,4,0,4,4
0168,AMINDIAN18,2,1,-1,2,1
0168,PISLAND18,0,0,0,0,0
0168,OTHER18,0,0,0,0,0
0168,OTHERMLT18,5,15,10,9,13
0169,PERSONS,1724,1659,-65,1698,1672
0169,WHITE,36,29,-7,33,30
0169,BLACK,1658,1560,-98,1619,1580
0169,HISPANIC,15,38,23,24,33
0169,ASIAN,12,1,-11,8,3
0169,AMINDIAN,0,5,5,2,4
0169,PISLAND,0,0,0,0,0
0169,OTHER,1,3,2,2,3
0169,OTHERMLT,2,23,21,10,19
0169,PERSONS18,1217,1162,-55,1195,1173
0169,WHITE18,34,24,-10,30,26
0169,BLACK18,1167,1095,-72,1138,1109
0169,HISPANIC18,9,28,19,17,24
0169,ASIAN18,4,1,-3,3,2
0169,AMINDIAN18,0,3,3,1,2
0169,PISLAND18,0,0,0,0,0
0169,OTHER18,1,1,0,1,1
0169,OTHERMLT18,2,10,8,5,8
0017,PERSONS,2541,2412,-129,2489,2438
0017,WHITE,76,43,-33,63,50
0017,BLACK,2402,2272,-130,2350,2298
0017,HISPANIC,29,67,38,44,59
0017,ASIAN,6,1,-5,4,2
0017,AMINDIAN,9,3,-6,7,4
0017,PISLAND,0,0,0,0,0
0017,OTHER,0,1,1,0,1
0017,OTHERMLT,19,25,6,21,24
0017,PERSONS18,1860,1794,-66,1834,1807
0017,WHITE18,68,38,-30,56,44
0017,BLACK18,1757,1708,-49,1737,1718
0017,HISPANIC18,16,35,19,24,31
0017,ASIAN18,2,1,-1,2,1
0017,AMINDIAN18,6,2,-4,4,3
0017,PISLAND18,0,0,0,0,0
0017,OTHER18,0,1,1,0,1
0017,OTHERMLT18,11,9,-2,10,9
0170,PERSONS,2022,1891,-131,1970,1917
0170,WHITE,123,65,-58,100,77
0170,BLACK,1827,1719,-108,1784,1741
0170,HISPANIC,25,42,17,32,39
0170,ASIAN,0,21,21,8,17
0170,AMINDIAN,8,3,-5,6,4
0170,PISLAND,0,0,0,0,0
0170,OTHER,4,0,-4,2,1
0170,OTHERMLT,35,41,6,37,40
0170,PERSONS18,1407,1333,-74,1377,1348
0170,WHITE18,113,63,-50,93,73
0170,BLACK18,1253,1209,-44,1235,1218
0170,HISPANIC18,17,24,7,20,23
0170,ASIAN18,0,13,13,5,10
0170,AMINDIAN18,6,3,-3,5,4
0170,PISLAND18,0,0,0,0,0
0170,OTHER18,2,0,-2,1,0
0170,OTHERMLT18,16,21,5,18,20
0171,PERSONS,2330,2162,-168,2263,2196
0171,WHITE,236,139,-97,197,158
0171,BLACK,2010,1900,-110,1966,1922
0171,HISPANIC,35,58,23,44,53
0171,ASIAN,12,2,-10,8,4
0171,AMINDIAN,8,8,0,8,8
0171,PISLAND,0,0,0,0,0
0171,OTHER,10,3,-7,7,4
0171,OTHERMLT,19,52,33,32,45
0171,PERSONS18,1599,1520,-79,1567,1536
0171,WHITE18,201,121,-80,169,137
0171,BLACK18,1347,1332,-15,1341,1335
0171,HISPANIC18,21,29,8,24,27
0171,ASIAN18,6,2,-4,4,3
0171,AMINDIAN18,7,6,-1,7,6
0171,PISLAND18,0,0,0,0,0
0171,OTHER18,3,1,-2,2,1
0171,OTHERMLT18,14,29,15,20,26
0172,PERSONS,3227,2929,-298,3108,2989
0172,WHITE,138,80,-58,115,92
0172,BLACK,2947,2663,-284,2833,2720
0172,HISPANIC,78,81,3,79,80
0172,ASIAN,28,39,11,32,37
0172,AMINDIAN,7,7,0,7,7
0172,PISLAND,0,0,0,0,0
0172,OTHER,7,2,-5,5,3
0172,OTHERMLT,22,57,35,36,50
0172,PERSONS18,2008,1949,-59,1984,1961
0172,WHITE18,122,72,-50,102,82
0172,BLACK18,1803,1769,-34,1789,1776
0172,HISPANIC18,44,54,10,48,52
0172,ASIAN18,16,21,5,18,20
0172,AMINDIAN18,6,4,-2,5,4
0172,PISLAND18,0,0,0,0,0
0172,OTHER18,2,1,-1,2,1
0172,OTHERMLT18,15,28,13,20,25
0173,PERSONS,2033,1583,-450,1853,1673
0173,WHITE,39,30,-9,35,32
0173,BLACK,1924,1460,-464,1738,1553
0173,HISPANIC,51,33,-18,44,37
0173,ASIAN,1,14,13,6,11
0173,AMINDIAN,7,3,-4,5,4
0173,PISLAND,0,0,0,0,0
0173,OTHER,8,0,-8,5,2
0173,OTHERMLT,3,43,40,19,35
0173,PERSONS18,1161,989,-172,1092,1023
0173,WHITE18,31,26,-5,29,27
0173,BLACK18,1092,915,-177,1021,950
0173,HISPANIC18,27,17,-10,23,19
0173,ASIAN18,1,14,13,6,11
0173,AMINDIAN18,5,3,-2,4,3
0173,PISLAND18,0,0,0,0,0
0173,OTHER18,3,0,-3,2,1
0173,OTHERMLT18,2,14,12,7,12
0174,PERSONS,1529,1295,-234,1435,1342
0174,WHITE,11,12,1,11,12
0174,BLACK,1463,1202,-261,1359,1254
0174,HISPANIC,38,35,-3,37,36
0174,ASIAN,10,19,9,14,17
0174,AMINDIAN,2,1,-1,2,1
0174,PISLAND,0,0,0,0,0
0174,OTHER,0,0,0,0,0
0174,OTHERMLT,5,26,21,13,22
0174,PERSONS18,925,831,-94,887,850
0174,WHITE18,10,11,1,10,11
0174,BLACK18,881,779,-102,840,799
0174,HISPANIC18,22,22,0,22,22
0174,ASIAN18,5,7,2,6,7
0174,AMINDIAN18,2,1,-1,2,1
0174,PISLAND18,0,0,0,0,0
0174,OTHER18,0,0,0,0,0
0174,OTHERMLT18,5,11,6,7,10
0175,PERSONS,1114,1076,-38,1099,1084
0175,WHITE,6,11,5,8,10
0175,BLACK,1077,1007,-70,1049,1021
0175,HISPANIC,1,29,28,12,23
0175,ASIAN,7,8,1,7,8
0175,AMINDIAN,0,9,9,4,7
0175,PISLAND,0,0,0,0,0
0175,OTHER,1,0,-1,1,0
0175,OTHERMLT,22,12,-10,18,14
0175,PERSONS18,658,673,15,664,670
0175,WHITE18,5,11,6,7,10
0175,BLACK18,636,629,-7,633,630
0175,HISPANIC18,1,21,20,9,17
0175,ASIAN18,4,5,1,4,5
0175,AMINDIAN18,0,4,4,2,3
0175,PISLAND18,0,0,0,0,0
0175,OTHER18,1,0,-1,1,0
0175,OTHERMLT18,11,3,-8,8,5
0176,PERSONS,1269,1034,-235,1175,1081
0176,WHITE,28,8,-20,20,12
0176,BLACK,1216,992,-224,1126,1037
0176,HISPANIC,7,20,13,12,17
0176,ASIAN,0,0,0,0,0
0176,AMINDIAN,5,1,-4,3,2
0176,PISLAND,0,1,1,0,1
0176,OTHER,0,0,0,0,0
0176,OTHERMLT,13,12,-1,13,12
0176,PERSONS18,785,688,-97,746,707
0176,WHITE18,8,8,0,8,8
0176,BLACK18,759,661,-98,720,681
0176,HISPANIC18,5,8,3,6,7
0176,ASIAN18,0,0,0,0,0
0176,AMINDIAN18,5,1,-4,3,2
0176,PISLAND18,0,1,1,0,1
0176,OTHER18,0,0,0,0,0
0176,OTHERMLT18,8,9,1,8,9
0177,PERSONS,1763,1608,-155,1701,1639
0177,WHITE,15,6,-9,11,8
0177,BLACK,1704,1538,-166,1638,1571
0177,HISPANIC,20,27,7,23,26
0177,ASIAN,9,1,-8,6,3
0177,AMINDIAN,1,3,2,2,3
0177,PISLAND,0,0,0,0,0
0177,OTHER,1,6,5,3,5
0177,OTHERMLT,13,27,14,19,24
0177,PERSONS18,1097,1036,-61,1073,1048
0177,WHITE18,8,5,-3,7,6
0177,BLACK18,1064,992,-72,1035,1006
0177,HISPANIC18,12,14,2,13,14
0177,ASIAN18,2,0,-2,1,0
0177,AMINDIAN18,1,3,2,2,3
0177,PISLAND18,0,0,0,0,0
0177,OTHER18,1,2,1,1,2
0177,OTHERMLT18,9,20,11,13,18
0178,PERSONS,1219,1046,-173,1150,1081
0178,WHITE,12,5,-7,9,6
0178,BLACK,1186,979,-207,1103,1020
0178,HISPANIC,6,32,26,16,27
0178,ASIAN,0,0,0,0,0
0178,AMINDIAN,1,5,4,3,4
0178,PISLAND,0,0,0,0,0
0178,OTHER,0,0,0,0,0
0178,OTHERMLT,14,25,11,18,23
0178,PERSONS18,719,678,-41,703,686
0178,WHITE18,9,5,-4,7,6
0178,BLACK18,698,645,-53,677,656
0178,HISPANIC18,3,13,10,7,11
0178,ASIAN18,0,0,0,0,0
0178,AMINDIAN18,0,5,5,2,4
0178,PISLAND18,0,0,0,0,0
0178,OTHER18,0,0,0,0,0
0178,OTHERMLT18,9,10,1,9,10
0179,PERSONS,2559,2102,-457,2376,2193
0179,WHITE,12,26,14,18,23
0179,BLACK,2498,1975,-523,2289,2080
0179,HISPANIC,30,57,27,41,52
0179,ASIAN,0,0,0,0,0
0179,AMINDIAN,3,4,1,3,4
0179,PISLAND,2,0,-2,1,0
0179,OTHER,3,4,1,3,4
0179,OTHERMLT,11,36,25,21,31
0179,PERSONS18,1420,1234,-186,1346,1271
0179,WHITE18,9,15,6,11,14
0179,BLACK18,1388,1171,-217,1301,1214
0179,HISPANIC18,15,22,7,18,21
0179,ASIAN18,0,0,0,0,0
0179,AMINDIAN18,2,3,1,2,3
0179,PISLAND18,0,0,0,0,0
0179,OTHER18,1,1,0,1,1
0179,OTHERMLT18,5,22,17,12,19
0018,PERSONS,2032,1908,-124,1982,1933
0018,WHITE,44,40,-4,42,41
0018,BLACK,1921,1773,-148,1862,1803
0018,HISPANIC,30,43,13,35,40
0018,ASIAN,1,3,2,2,3
0018,AMINDIAN,14,4,-10,10,6
0018,PISLAND,0,0,0,0,0
0018,OTHER,0,1,1,0,1
0018,OTHERMLT,22,44,22,31,40
0018,PERSONS18,1404,1363,-41,1388,1371
0018,WHITE18,38,37,-1,38,37
0018,BLACK18,1325,1278,-47,1306,1287
0018,HISPANIC18,20,19,-1,20,19
0018,ASIAN18,1,3,2,2,3
0018,AMINDIAN18,10,3,-7,7,4
0018,PISLAND18,0,0,0,0,0
0018,OTHER18,0,0,0,0,0
0018,OTHERMLT18,10,23,13,15,20
0180,PERSONS,3308,2732,-576,3078,2847
0180,WHITE,45,32,-13,40,35
0180,BLACK,3206,2596,-610,2962,2718
0180,HISPANIC,21,31,10,25,29
0180,ASIAN,3,18,15,9,15
0180,AMINDIAN,7,7,0,7,7
0180,PISLAND,0,0,0,0,0
0180,OTHER,13,4,-9,9,6
0180,OTHERMLT,13,44,31,25,38
0180,PERSONS18,1876,1737,-139,1820,1765
0180,WHITE18,32,31,-1,32,31
0180,BLACK18,1816,1649,-167,1749,1682
0180,HISPANIC18,11,17,6,13,16
0180,ASIAN18,3,13,10,7,11
0180,AMINDIAN18,4,5,1,4,5
0180,PISLAND18,0,0,0,0,0
0180,OTHER18,2,2,0,2,2
0180,OTHERMLT18,8,20,12,13,18
0181,PERSONS,1565,1530,-35,1551,1537
0181,WHITE,46,58,12,51,56
0181,BLACK,1461,1406,-55,1439,1417
0181,HISPANIC,29,34,5,31,33
0181,ASIAN,1,13,12,6,11
0181,AMINDIAN,13,5,-8,10,7
0181,PISLAND,0,1,1,0,1
0181,OTHER,2,0,-2,1,0
0181,OTHERMLT,13,13,0,13,13
0181,PERSONS18,879,1022,143,936,993
0181,WHITE18,36,55,19,44,51
0181,BLACK18,810,933,123,859,908
0181,HISPANIC18,16,15,-1,16,15
0181,ASIAN18,0,5,5,2,4
0181,AMINDIAN18,5,4,-1,5,4
0181,PISLAND18,0,1,1,0,1
0181,OTHER18,1,0,-1,1,0
0181,OTHERMLT18,11,9,-2,10,9
0186,PERSONS,1386,1322,-64,1360,1335
0186,WHITE,1303,1093,-210,1219,1135
0186,BLACK,12,15,3,13,14
0186,HISPANIC,50,157,107,93,136
0186,ASIAN,5,22,17,12,19
0186,AMINDIAN,11,6,-5,9,7
0186,PISLAND,2,1,-1,2,1
0186,OTHER,3,0,-3,2,1
0186,OTHERMLT,0,28,28,11,22
0186,PERSONS18,1088,1058,-30,1076,1064
0186,WHITE18,1041,913,-128,990,939
0186,BLACK18,5,11,6,7,10
0186,HISPANIC18,27,97,70,55,83
0186,ASIAN18,2,15,13,7,12
0186,AMINDIAN18,8,6,-2,7,6
0186,PISLAND18,2,1,-1,2,1
0186,OTHER18,3,0,-3,2,1
0186,OTHERMLT18,0,15,15,6,12
0187,PERSONS,1114,1070,-44,1096,1079
0187,WHITE,1027,906,-121,979,930
0187,BLACK,27,17,-10,23,19
0187,HISPANIC,52,107,55,74,96
0187,ASIAN,4,9,5,6,8
0187,AMINDIAN,3,11,8,6,9
0187,PISLAND,0,0,0,0,0
0187,OTHER,1,1,0,1,1
0187,OTHERMLT,0,19,19,8,15
0187,PERSONS18,907,874,-33,894,881
0187,WHITE18,862,784,-78,831,800
0187,BLACK18,9,8,-1,9,8
0187,HISPANIC18,32,63,31,44,57
0187,ASIAN18,3,7,4,5,6
0187,AMINDIAN18,1,7,6,3,6
0187,PISLAND18,0,0,0,0,0
0187,OTHER18,0,0,0,0,0
0187,OTHERMLT18,0,5,5,2,4
0188,PERSONS,1953,2035,82,1986,2019
0188,WHITE,1829,1664,-165,1763,1697
0188,BLACK,10,41,31,22,35
0188,HISPANIC,83,244,161,147,212
0188,ASIAN,20,48,28,31,42
0188,AMINDIAN,10,13,3,11,12
0188,PISLAND,0,0,0,0,0
0188,OTHER,1,0,-1,1,0
0188,OTHERMLT,0,25,25,10,20
0188,PERSONS18,1621,1648,27,1632,1643
0188,WHITE18,1542,1408,-134,1488,1435
0188,BLACK18,7,29,22,16,25
0188,HISPANIC18,50,148,98,89,128
0188,ASIAN18,13,37,24,23,32
0188,AMINDIAN18,8,12,4,10,11
0188,PISLAND18,0,0,0,0,0
0188,OTHER18,1,0,-1,1,0
0188,OTHERMLT18,0,14,14,6,11
0189,PERSONS,2262,2285,23,2271,2280
0189,WHITE,2036,1777,-259,1932,1829
0189,BLACK,61,58,-3,60,59
0189,HISPANIC,114,338,224,204,293
0189,ASIAN,23,35,12,28,33
0189,AMINDIAN,23,31,8,26,29
0189,PISLAND,2,0,-2,1,0
0189,OTHER,3,6,3,4,5
0189,OTHERMLT,0,40,40,16,32
0189,PERSONS18,1830,1812,-18,1823,1816
0189,WHITE18,1709,1497,-212,1624,1539
0189,BLACK18,21,38,17,28,35
0189,HISPANIC18,68,214,146,126,185
0189,ASIAN18,15,25,10,19,23
0189,AMINDIAN18,15,20,5,17,19
0189,PISLAND18,2,0,-2,1,0
0189,OTHER18,0,5,5,2,4
0189,OTHERMLT18,0,13,13,5,10
0019,PERSONS,1944,1763,-181,1872,1799
0019,WHITE,25,17,-8,22,19
0019,BLACK,1854,1641,-213,1769,1684
0019,HISPANIC,18,42,24,28,37
0019,ASIAN,24,20,-4,22,21
0019,AMINDIAN,3,17,14,9,14
0019,PISLAND,0,0,0,0,0
0019,OTHER,9,2,-7,6,3
0019,OTHERMLT,11,24,13,16,21
0019,PERSONS18,1275,1242,-33,1262,1249
0019,WHITE18,23,17,-6,21,18
0019,BLACK18,1213,1169,-44,1195,1178
0019,HISPANIC18,7,20,13,12,17
0019,ASIAN18,16,12,-4,14,13
0019,AMINDIAN18,3,8,5,5,7
0019,PISLAND18,0,0,0,0,0
0019,OTHER18,4,2,-2,3,2
0019,OTHERMLT18,9,14,5,11,13
0198,PERSONS,2137,2165,28,2148,2159
0198,WHITE,1918,1701,-217,1831,1744
0198,BLACK,11,59,48,30,49
0198,HISPANIC,118,309,191,194,271
0198,ASIAN,36,20,-16,30,23
0198,AMINDIAN,20,19,-1,20,19
0198,PISLAND,5,0,-5,3,1
0198,OTHER,27,2,-25,17,7
0198,OTHERMLT,2,55,53,23,44
0198,PERSONS18,1723,1712,-11,1719,1714
0198,WHITE18,1592,1414,-178,1521,1450
0198,BLACK18,4,43,39,20,35
0198,HISPANIC18,71,199,128,122,173
0198,ASIAN18,21,19,-2,20,19
0198,AMINDIAN18,15,9,-6,13,10
0198,PISLAND18,2,0,-2,1,0
0198,OTHER18,17,0,-17,10,3
0198,OTHERMLT18,1,28,27,12,23
0199,PERSONS,1955,1899,-56,1933,1910
0199,WHITE,1733,1381,-352,1592,1451
0199,BLACK,17,73,56,39,62
0199,HISPANIC,107,364,257,210,313
0199,ASIAN,57,34,-23,48,39
0199,AMINDIAN,26,22,-4,24,23
0199,PISLAND,2,0,-2,1,0
0199,OTHER,7,1,-6,5,2
0199,OTHERMLT,6,24,18,13,20
0199,PERSONS18,1513,1455,-58,1490,1467
0199,WHITE18,1366,1143,-223,1277,1188
0199,BLACK18,8,41,33,21,34
0199,HISPANIC18,72,213,141,128,185
0199,ASIAN18,38,26,-12,33,28
0199,AMINDIAN18,17,19,2,18,19
0199,PISLAND18,2,0,-2,1,0
0199,OTHER18,5,0,-5,3,1
0199,OTHERMLT18,5,13,8,8,11
0002,PERSONS,1259,1261,2,1260,1261
0002,WHITE,49,29,-20,41,33
0002,BLACK,1177,1164,-13,1172,1167
0002,HISPANIC,18,43,25,28,38
0002,ASIAN,5,2,-3,4,3
0002,AMINDIAN,3,2,-1,3,2
0002,PISLAND,0,0,0,0,0
0002,OTHER,3,1,-2,2,1
0002,OTHERMLT,4,20,16,10,17
0002,PERSONS18,794,827,33,807,820
0002,WHITE18,49,28,-21,41,32
0002,BLACK18,726,763,37,741,756
0002,HISPANIC18,11,20,9,15,18
0002,ASIAN18,4,2,-2,3,2
0002,AMINDIAN18,2,2,0,2,2
0002,PISLAND18,0,0,0,0,0
0002,OTHER18,1,1,0,1,1
0002,OTHERMLT18,1,11,10,5,9
0203,PERSONS,2540,2263,-277,2429,2318
0203,WHITE,346,241,-105,304,262
0203,BLACK,303,195,-108,260,217
0203,HISPANIC,1817,1715,-102,1776,1735
0203,ASIAN,38,68,30,50,62
0203,AMINDIAN,18,17,-1,18,17
0203,PISLAND,0,0,0,0,0
0203,OTHER,7,0,-7,4,1
0203,OTHERMLT,11,27,16,17,24
0203,PERSONS18,1679,1528,-151,1619,1558
0203,WHITE18,291,215,-76,261,230
0203,BLACK18,163,120,-43,146,129
0203,HISPANIC18,1174,1131,-43,1157,1140
0203,ASIAN18,25,40,15,31,37
0203,AMINDIAN18,17,13,-4,15,14
0203,PISLAND18,0,0,0,0,0
0203,OTHER18,5,0,-5,3,1
0203,OTHERMLT18,4,9,5,6,8
0204,PERSONS,2516,2063,-453,2335,2154
0204,WHITE,345,196,-149,285,226
0204,BLACK,235,256,21,243,252
0204,HISPANIC,1836,1542,-294,1718,1601
0204,ASIAN,67,25,-42,50,33
0204,AMINDIAN,25,11,-14,19,14
0204,PISLAND,2,0,-2,1,0
0204,OTHER,6,9,3,7,8
0204,OTHERMLT,0,24,24,10,19
0204,PERSONS18,1641,1364,-277,1530,1419
0204,WHITE18,300,157,-143,243,186
0204,BLACK18,143,138,-5,141,139
0204,HISPANIC18,1135,1020,-115,1089,1043
0204,ASIAN18,38,23,-15,32,26
0204,AMINDIAN18,18,11,-7,15,12
0204,PISLAND18,2,0,-2,1,0
0204,OTHER18,5,3,-2,4,3
0204,OTHERMLT18,0,12,12,5,10
0205,PERSONS,1891,1860,-31,1879,1866
0205,WHITE,174,139,-35,160,146
0205,BLACK,225,212,-13,220,215
0205,HISPANIC,1323,1457,134,1377,1430
0205,ASIAN,124,18,-106,82,39
0205,AMINDIAN,15,22,7,18,21
0205,PISLAND,0,1,1,0,1
0205,OTHER,9,0,-9,5,2
0205,OTHERMLT,21,11,-10,17,13
0205,PERSONS18,1225,1190,-35,1211,1197
0205,WHITE18,153,112,-41,137,120
0205,BLACK18,97,118,21,105,114
0205,HISPANIC18,888,927,39,904,919
0205,ASIAN18,56,13,-43,39,22
0205,AMINDIAN18,7,14,7,10,13
0205,PISLAND18,0,1,1,0,1
0205,OTHER18,9,0,-9,5,2
0205,OTHERMLT18,15,5,-10,11,7
0206,PERSONS,2395,2152,-243,2298,2201
0206,WHITE,437,279,-158,374,311
0206,BLACK,189,282,93,226,263
0206,HISPANIC,1620,1465,-155,1558,1496
0206,ASIAN,104,86,-18,97,90
0206,AMINDIAN,20,11,-9,16,13
0206,PISLAND,1,2,1,1,2
0206,OTHER,6,0,-6,4,1
0206,OTHERMLT,18,27,9,22,25
0206,PERSONS18,1563,1426,-137,1508,1453
0206,WHITE18,335,242,-93,298,261
0206,BLACK18,113,169,56,135,158
0206,HISPANIC18,1029,932,-97,990,951
0206,ASIAN18,64,61,-3,63,62
0206,AMINDIAN18,11,8,-3,10,9
0206,PISLAND18,1,2,1,1,2
0206,OTHER18,4,0,-4,2,1
0206,OTHERMLT18,6,12,6,8,11
0207,PERSONS,2701,2578,-123,2652,2603
0207,WHITE,507,317,-190,431,355
0207,BLACK,116,273,157,179,242
0207,HISPANIC,1804,1873,69,1832,1859
0207,ASIAN,181,53,-128,130,79
0207,AMINDIAN,63,9,-54,41,20
0207,PISLAND,0,0,0,0,0
0207,OTHER,21,3,-18,14,7
0207,OTHERMLT,9,50,41,25,42
0207,PERSONS18,1702,1625,-77,1671,1640
0207,WHITE18,405,262,-143,348,291
0207,BLACK18,59,148,89,95,130
0207,HISPANIC18,1084,1157,73,1113,1142
0207,ASIAN18,85,34,-51,65,44
0207,AMINDIAN18,51,5,-46,33,14
0207,PISLAND18,0,0,0,0,0
0207,OTHER18,12,0,-12,7,2
0207,OTHERMLT18,6,19,13,11,16
0208,PERSONS,1960,1991,31,1972,1985
0208,WHITE,361,168,-193,284,207
0208,BLACK,180,192,12,185,190
0208,HISPANIC,1295,1544,249,1395,1494
0208,ASIAN,80,54,-26,70,59
0208,AMINDIAN,34,6,-28,23,12
0208,PISLAND,1,1,0,1,1
0208,OTHER,5,5,0,5,5
0208,OTHERMLT,4,21,17,11,18
0208,PERSONS18,1253,1242,-11,1249,1244
0208,WHITE18,297,142,-155,235,173
0208,BLACK18,75,110,35,89,103
0208,HISPANIC18,801,933,132,854,907
0208,ASIAN18,54,37,-17,47,40
0208,AMINDIAN18,18,6,-12,13,8
0208,PISLAND18,1,1,0,1,1
0208,OTHER18,4,4,0,4,4
0208,OTHERMLT18,3,9,6,5,8
0209,PERSONS,2939,3033,94,2977,3014
0209,WHITE,325,301,-24,315,306
0209,BLACK,144,303,159,208,271
0209,HISPANIC,2354,2332,-22,2345,2336
0209,ASIAN,40,32,-8,37,34
0209,AMINDIAN,47,21,-26,37,26
0209,PISLAND,0,5,5,2,4
0209,OTHER,20,4,-16,14,7
0209,OTHERMLT,9,35,26,19,30
0209,PERSONS18,1849,1992,143,1906,1963
0209,WHITE18,258,268,10,262,266
0209,BLACK18,58,197,139,114,169
0209,HISPANIC18,1464,1465,1,1464,1465
0209,ASIAN18,30,22,-8,27,24
0209,AMINDIAN18,31,15,-16,25,18
0209,PISLAND18,0,4,4,2,3
0209,OTHER18,7,2,-5,5,3
0209,OTHERMLT18,1,19,18,8,15
0021,PERSONS,1689,1662,-27,1678,1667
0021,WHITE,583,292,-291,467,350
0021,BLACK,929,1063,134,983,1036
0021,HISPANIC,47,57,10,51,55
0021,ASIAN,105,198,93,142,179
0021,AMINDIAN,6,1,-5,4,2
0021,PISLAND,5,0,-5,3,1
0021,OTHER,3,0,-3,2,1
0021,OTHERMLT,11,51,40,27,43
0021,PERSONS18,1126,1122,-4,1124,1123
0021,WHITE18,502,266,-236,408,313
0021,BLACK18,537,697,160,601,665
0021,HISPANIC18,21,29,8,24,27
0021,ASIAN18,51,107,56,73,96
0021,AMINDIAN18,5,1,-4,3,2
0021,PISLAND18,4,0,-4,2,1
0021,OTHER18,1,0,-1,1,0
0021,OTHERMLT18,5,22,17,12,19
0210,PERSONS,2310,2296,-14,2304,2299
0210,WHITE,457,310,-147,398,339
0210,BLACK,175,224,49,195,214
0210,HISPANIC,1563,1675,112,1608,1653
0210,ASIAN,25,18,-7,22,19
0210,AMINDIAN,65,31,-34,51,38
0210,PISLAND,1,0,-1,1,0
0210,OTHER,19,8,-11,15,10
0210,OTHERMLT,5,30,25,15,25
0210,PERSONS18,1474,1506,32,1487,1500
0210,WHITE18,377,276,-101,337,296
0210,BLACK18,81,126,45,99,117
0210,HISPANIC18,946,1038,92,983,1020
0210,ASIAN18,10,17,7,13,16
0210,AMINDIAN18,47,27,-20,39,31
0210,PISLAND18,1,0,-1,1,0
0210,OTHER18,10,8,-2,9,8
0210,OTHERMLT18,2,14,12,7,12
0285,PERSONS,1239,1277,38,1254,1269
0285,WHITE,1183,1109,-74,1153,1124
0285,BLACK,9,32,23,18,27
0285,HISPANIC,30,90,60,54,78
0285,ASIAN,7,14,7,10,13
0285,AMINDIAN,10,12,2,11,12
0285,PISLAND,0,0,0,0,0
0285,OTHER,0,2,2,1,2
0285,OTHERMLT,0,18,18,7,14
0285,PERSONS18,1033,1064,31,1045,1058
0285,WHITE18,992,968,-24,982,973
0285,BLACK18,5,21,16,11,18
0285,HISPANIC18,22,52,30,34,46
0285,ASIAN18,6,7,1,6,7
0285,AMINDIAN18,8,8,0,8,8
0285,PISLAND18,0,0,0,0,0
0285,OTHER18,0,0,0,0,0
0285,OTHERMLT18,0,8,8,3,6
0286,PERSONS,1678,1616,-62,1653,1628
0286,WHITE,1390,1187,-203,1309,1228
0286,BLACK,95,130,35,109,123
0286,HISPANIC,94,189,95,132,170
0286,ASIAN,71,82,11,75,80
0286,AMINDIAN,22,6,-16,16,9
0286,PISLAND,0,0,0,0,0
0286,OTHER,4,1,-3,3,2
0286,OTHERMLT,2,21,19,10,17
0286,PERSONS18,1250,1241,-9,1246,1243
0286,WHITE18,1133,973,-160,1069,1005
0286,BLACK18,7,76,69,35,62
0286,HISPANIC18,43,108,65,69,95
0286,ASIAN18,53,70,17,60,67
0286,AMINDIAN18,13,5,-8,10,7
0286,PISLAND18,0,0,0,0,0
0286,OTHER18,0,1,1,0,1
0286,OTHERMLT18,1,8,7,4,7
0287,PERSONS,1166,1342,176,1236,1307
0287,WHITE,1072,1148,76,1102,1133
0287,BLACK,7,53,46,25,44
0287,HISPANIC,28,63,35,42,56
0287,ASIAN,55,54,-1,55,54
0287,AMINDIAN,2,6,4,4,5
0287,PISLAND,1,0,-1,1,0
0287,OTHER,0,2,2,1,2
0287,OTHERMLT,1,16,15,7,13
0287,PERSONS18,1032,1215,183,1105,1178
0287,WHITE18,953,1072,119,1001,1048
0287,BLACK18,6,35,29,18,29
0287,HISPANIC18,24,44,20,32,40
0287,ASIAN18,45,49,4,47,48
0287,AMINDIAN18,2,4,2,3,4
0287,PISLAND18,1,0,-1,1,0
0287,OTHER18,0,0,0,0,0
0287,OTHERMLT18,1,11,10,5,9
0253,PERSONS,1553,1409,-144,1495,1438
0253,WHITE,1453,1296,-157,1390,1327
0253,BLACK,5,10,5,7,9
0253,HISPANIC,64,75,11,68,73
0253,ASIAN,25,13,-12,20,15
0253,AMINDIAN,6,5,-1,6,5
0253,PISLAND,0,0,0,0,0
0253,OTHER,0,1,1,0,1
0253,OTHERMLT,0,9,9,4,7
0253,PERSONS18,1294,1203,-91,1258,1221
0253,WHITE18,1220,1125,-95,1182,1144
0253,BLACK18,2,6,4,4,5
0253,HISPANIC18,46,52,6,48,51
0253,ASIAN18,22,10,-12,17,12
0253,AMINDIAN18,4,5,1,4,5
0253,PISLAND18,0,0,0,0,0
0253,OTHER18,0,0,0,0,0
0253,OTHERMLT18,0,5,5,2,4
0254,PERSONS,1282,1194,-88,1247,1212
0254,WHITE,1151,1012,-139,1095,1040
0254,BLACK,10,9,-1,10,9
0254,HISPANIC,89,97,8,92,95
0254,ASIAN,15,19,4,17,18
0254,AMINDIAN,12,19,7,15,18
0254,PISLAND,0,0,0,0,0
0254,OTHER,4,7,3,5,6
0254,OTHERMLT,1,31,30,13,25
0254,PERSONS18,1007,994,-13,1002,997
0254,WHITE18,929,881,-48,910,891
0254,BLACK18,8,7,-1,8,7
0254,HISPANIC18,50,59,9,54,57
0254,ASIAN18,10,16,6,12,15
0254,AMINDIAN18,6,14,8,9,12
0254,PISLAND18,0,0,0,0,0
0254,OTHER18,3,2,-1,3,2
0254,OTHERMLT18,1,15,14,7,12
0255,PERSONS,2029,1900,-129,1977,1926
0255,WHITE,1875,1586,-289,1759,1644
0255,BLACK,15,42,27,26,37
0255,HISPANIC,93,211,118,140,187
0255,ASIAN,10,17,7,13,16
0255,AMINDIAN,32,12,-20,24,16
0255,PISLAND,0,0,0,0,0
0255,OTHER,2,0,-2,1,0
0255,OTHERMLT,2,32,30,14,26
0255,PERSONS18,1612,1510,-102,1571,1530
0255,WHITE18,1512,1328,-184,1438,1365
0255,BLACK18,7,29,22,16,25
0255,HISPANIC18,63,121,58,86,109
0255,ASIAN18,6,7,1,6,7
0255,AMINDIAN18,20,8,-12,15,10
0255,PISLAND18,0,0,0,0,0
0255,OTHER18,2,0,-2,1,0
0255,OTHERMLT18,2,17,15,8,14
0256,PERSONS,1563,1512,-51,1543,1522
0256,WHITE,1481,1286,-195,1403,1325
0256,BLACK,8,14,6,10,13
0256,HISPANIC,55,152,97,94,133
0256,ASIAN,13,24,11,17,22
0256,AMINDIAN,6,11,5,8,10
0256,PISLAND,0,2,2,1,2
0256,OTHER,0,0,0,0,0
0256,OTHERMLT,0,23,23,9,18
0256,PERSONS18,1251,1241,-10,1247,1243
0256,WHITE18,1198,1098,-100,1158,1118
0256,BLACK18,5,9,4,7,8
0256,HISPANIC18,34,93,59,58,81
0256,ASIAN18,8,17,9,12,15
0256,AMINDIAN18,6,9,3,7,8
0256,PISLAND18,0,2,2,1,2
0256,OTHER18,0,0,0,0,0
0256,OTHERMLT18,0,13,13,5,10
0295,PERSONS,2134,2451,317,2261,2388
0295,WHITE,1081,551,-530,869,657
0295,BLACK,42,58,16,48,55
0295,HISPANIC,849,1681,832,1182,1515
0295,ASIAN,111,111,0,111,111
0295,AMINDIAN,33,22,-11,29,24
0295,PISLAND,0,0,0,0,0
0295,OTHER,7,0,-7,4,1
0295,OTHERMLT,11,28,17,18,25
0295,PERSONS18,1492,1618,126,1542,1593
0295,WHITE18,853,465,-388,698,543
0295,BLACK18,22,43,21,30,39
0295,HISPANIC18,507,993,486,701,896
0295,ASIAN18,68,81,13,73,78
0295,AMINDIAN18,30,18,-12,25,20
0295,PISLAND18,0,0,0,0,0
0295,OTHER18,4,0,-4,2,1
0295,OTHERMLT18,8,18,10,12,16
0296,PERSONS,2872,3350,478,3063,3254
0296,WHITE,1194,568,-626,944,693
0296,BLACK,78,87,9,82,85
0296,HISPANIC,1195,2495,1300,1715,2235
0296,ASIAN,306,124,-182,233,160
0296,AMINDIAN,53,32,-21,45,36
0296,PISLAND,0,0,0,0,0
0296,OTHER,27,0,-27,16,5
0296,OTHERMLT,19,44,25,29,39
0296,PERSONS18,1915,2079,164,1981,2046
0296,WHITE18,939,488,-451,759,578
0296,BLACK18,45,52,7,48,51
0296,HISPANIC18,712,1413,701,992,1273
0296,ASIAN18,161,87,-74,131,102
0296,AMINDIAN18,31,22,-9,27,24
0296,PISLAND18,0,0,0,0,0
0296,OTHER18,17,0,-17,10,3
0296,OTHERMLT18,10,17,7,13,16
0297,PERSONS,1086,1107,21,1094,1103
0297,WHITE,16,20,4,18,19
0297,BLACK,1046,1031,-15,1040,1034
0297,HISPANIC,12,27,15,18,24
0297,ASIAN,0,1,1,0,1
0297,AMINDIAN,5,5,0,5,5
0297,PISLAND,1,0,-1,1,0
0297,OTHER,0,0,0,0,0
0297,OTHERMLT,6,23,17,13,20
0297,PERSONS18,671,707,36,685,700
0297,WHITE18,13,15,2,14,15
0297,BLACK18,641,660,19,649,656
0297,HISPANIC18,8,17,9,12,15
0297,ASIAN18,0,1,1,0,1
0297,AMINDIAN18,4,3,-1,4,3
0297,PISLAND18,1,0,-1,1,0
0297,OTHER18,0,0,0,0,0
0297,OTHERMLT18,4,11,7,7,10
0298,PERSONS,1936,1660,-276,1826,1715
0298,WHITE,29,23,-6,27,24
0298,BLACK,1824,1532,-292,1707,1590
0298,HISPANIC,50,70,20,58,66
0298,ASIAN,6,8,2,7,8
0298,AMINDIAN,2,2,0,2,2
0298,PISLAND,0,0,0,0,0
0298,OTHER,0,2,2,1,2
0298,OTHERMLT,25,23,-2,24,23
0298,PERSONS18,1100,1060,-40,1084,1068
0298,WHITE18,17,21,4,19,20
0298,BLACK18,1040,985,-55,1018,996
0298,HISPANIC18,26,34,8,29,32
0298,ASIAN18,2,8,6,4,7
0298,AMINDIAN18,2,2,0,2,2
0298,PISLAND18,0,0,0,0,0
0298,OTHER18,0,2,2,1,2
0298,OTHERMLT18,13,8,-5,11,9
0288,PERSONS,1907,1869,-38,1892,1877
0288,WHITE,1641,1306,-335,1507,1373
0288,BLACK,51,118,67,78,105
0288,HISPANIC,132,305,173,201,270
0288,ASIAN,41,25,-16,35,28
0288,AMINDIAN,24,37,13,29,34
0288,PISLAND,0,0,0,0,0
0288,OTHER,11,0,-11,7,2
0288,OTHERMLT,7,78,71,35,64
0288,PERSONS18,1452,1429,-23,1443,1434
0288,WHITE18,1293,1100,-193,1216,1139
0288,BLACK18,19,66,47,38,57
0288,HISPANIC18,83,184,101,123,164
0288,ASIAN18,32,19,-13,27,22
0288,AMINDIAN18,17,26,9,21,24
0288,PISLAND18,0,0,0,0,0
0288,OTHER18,5,0,-5,3,1
0288,OTHERMLT18,3,34,31,15,28
0308,PERSONS,1776,1605,-171,1708,1639
0308,WHITE,56,67,11,60,65
0308,BLACK,991,765,-226,901,810
0308,HISPANIC,50,24,-26,40,29
0308,ASIAN,583,708,125,633,683
0308,AMINDIAN,6,1,-5,4,2
0308,PISLAND,0,0,0,0,0
0308,OTHER,1,5,4,3,4
0308,OTHERMLT,89,35,-54,67,46
0308,PERSONS18,871,898,27,882,893
0308,WHITE18,55,61,6,57,60
0308,BLACK18,481,440,-41,465,448
0308,HISPANIC18,28,15,-13,23,18
0308,ASIAN18,270,361,91,306,343
0308,AMINDIAN18,4,0,-4,2,1
0308,PISLAND18,0,0,0,0,0
0308,OTHER18,0,3,3,1,2
0308,OTHERMLT18,33,18,-15,27,21
0309,PERSONS,1734,1606,-128,1683,1632
0309,WHITE,63,48,-15,57,51
0309,BLACK,1468,1322,-146,1410,1351
0309,HISPANIC,89,97,8,92,95
0309,ASIAN,81,89,8,84,87
0309,AMINDIAN,12,2,-10,8,4
0309,PISLAND,2,0,-2,1,0
0309,OTHER,0,3,3,1,2
0309,OTHERMLT,19,45,26,29,40
0309,PERSONS18,969,1082,113,1014,1059
0309,WHITE18,55,35,-20,47,39
0309,BLACK18,803,900,97,842,881
0309,HISPANIC18,49,63,14,55,60
0309,ASIAN18,45,64,19,53,60
0309,AMINDIAN18,9,1,-8,6,3
0309,PISLAND18,1,0,-1,1,0
0309,OTHER18,0,2,2,1,2
0309,OTHERMLT18,7,17,10,11,15
0031,PERSONS,2125,2073,-52,2104,2083
0031,WHITE,868,350,-518,661,454
0031,BLACK,923,1401,478,1114,1305
0031,HISPANIC,64,66,2,65,66
0031,ASIAN,226,213,-13,221,216
0031,AMINDIAN,7,9,2,8,9
0031,PISLAND,0,0,0,0,0
0031,OTHER,3,1,-2,2,1
0031,OTHERMLT,34,33,-1,34,33
0031,PERSONS18,1500,1469,-31,1488,1475
0031,WHITE18,740,328,-412,575,410
0031,BLACK18,574,929,355,716,858
0031,HISPANIC18,40,41,1,40,41
0031,ASIAN18,120,147,27,131,142
0031,AMINDIAN18,6,6,0,6,6
0031,PISLAND18,0,0,0,0,0
0031,OTHER18,3,1,-2,2,1
0031,OTHERMLT18,17,17,0,17,17
0310,PERSONS,2031,1836,-195,1953,1875
0310,WHITE,149,123,-26,139,128
0310,BLACK,1611,1477,-134,1557,1504
0310,HISPANIC,89,63,-26,79,68
0310,ASIAN,152,112,-40,136,120
0310,AMINDIAN,6,5,-1,6,5
0310,PISLAND,0,0,0,0,0
0310,OTHER,8,1,-7,5,2
0310,OTHERMLT,16,55,39,32,47
0310,PERSONS18,1206,1152,-54,1184,1163
0310,WHITE18,132,118,-14,126,121
0310,BLACK18,917,880,-37,902,887
0310,HISPANIC18,54,40,-14,48,43
0310,ASIAN18,82,85,3,83,84
0310,AMINDIAN18,5,3,-2,4,3
0310,PISLAND18,0,0,0,0,0
0310,OTHER18,4,1,-3,3,2
0310,OTHERMLT18,12,25,13,17,22
0311,PERSONS,2454,3229,775,2764,3074
0311,WHITE,1284,1892,608,1527,1770
0311,BLACK,830,1019,189,906,981
0311,HISPANIC,131,160,29,143,154
0311,ASIAN,148,100,-48,129,110
0311,AMINDIAN,29,9,-20,21,13
0311,PISLAND,5,2,-3,4,3
0311,OTHER,10,8,-2,9,8
0311,OTHERMLT,17,39,22,26,35
0311,PERSONS18,2097,2775,678,2368,2639
0311,WHITE18,1272,1856,584,1506,1739
0311,BLACK18,540,635,95,578,616
0311,HISPANIC18,99,138,39,115,130
0311,ASIAN18,137,100,-37,122,107
0311,AMINDIAN18,22,8,-14,16,11
0311,PISLAND18,4,2,-2,3,2
0311,OTHER18,10,8,-2,9,8
0311,OTHERMLT18,13,28,15,19,25
0312,PERSONS,2034,2585,551,2254,2475
0312,WHITE,1649,2107,458,1832,2015
0312,BLACK,143,117,-26,133,122
0312,HISPANIC,75,133,58,98,121
0312,ASIAN,128,204,76,158,189
0312,AMINDIAN,16,3,-13,11,6
0312,PISLAND,4,2,-2,3,2
0312,OTHER,5,0,-5,3,1
0312,OTHERMLT,14,19,5,16,18
0312,PERSONS18,2029,2569,540,2245,2461
0312,WHITE18,1649,2100,451,1829,2010
0312,BLACK18,143,117,-26,133,122
0312,HISPANIC18,75,133,58,98,121
0312,ASIAN18,123,195,72,152,181
0312,AMINDIAN18,16,3,-13,11,6
0312,PISLAND18,4,2,-2,3,2
0312,OTHER18,5,0,-5,3,1
0312,OTHERMLT18,14,19,5,16,18
0313,PERSONS,1814,1486,-328,1683,1552
0313,WHITE,101,142,41,117,134
0313,BLACK,1504,1164,-340,1368,1232
0313,HISPANIC,80,54,-26,70,59
0313,ASIAN,108,76,-32,95,82
0313,AMINDIAN,4,5,1,4,5
0313,PISLAND,0,0,0,0,0
0313,OTHER,0,0,0,0,0
0313,OTHERMLT,17,45,28,28,39
0313,PERSONS18,1133,1073,-60,1109,1085
0313,WHITE18,94,131,37,109,124
0313,BLACK18,928,834,-94,890,853
0313,HISPANIC18,46,32,-14,40,35
0313,ASIAN18,52,54,2,53,54
0313,AMINDIAN18,1,2,1,1,2
0313,PISLAND18,0,0,0,0,0
0313,OTHER18,0,0,0,0,0
0313,OTHERMLT18,12,20,8,15,18
0314,PERSONS,1426,1571,145,1484,1542
0314,WHITE,28,42,14,34,39
0314,BLACK,1275,1387,112,1320,1365
0314,HISPANIC,36,34,-2,35,34
0314,ASIAN,70,81,11,74,79
0314,AMINDIAN,0,0,0,0,0
0314,PISLAND,1,0,-1,1,0
0314,OTHER,0,4,4,2,3
0314,OTHERMLT,16,23,7,19,22
0314,PERSONS18,823,1015,192,900,977
0314,WHITE18,28,42,14,34,39
0314,BLACK18,737,894,157,800,863
0314,HISPANIC18,19,23,4,21,22
0314,ASIAN18,30,44,14,36,41
0314,AMINDIAN18,0,0,0,0,0
0314,PISLAND18,1,0,-1,1,0
0314,OTHER18,0,1,1,0,1
0314,OTHERMLT18,8,11,3,9,10
0083,PERSONS,1364,1455,91,1400,1437
0083,WHITE,836,346,-490,640,444
0083,BLACK,415,879,464,601,786
0083,HISPANIC,36,69,33,49,62
0083,ASIAN,48,79,31,60,73
0083,AMINDIAN,11,7,-4,9,8
0083,PISLAND,1,0,-1,1,0
0083,OTHER,2,0,-2,1,0
0083,OTHERMLT,15,75,60,39,63
0083,PERSONS18,1014,970,-44,996,979
0083,WHITE18,694,307,-387,539,384
0083,BLACK18,254,548,294,372,489
0083,HISPANIC18,17,38,21,25,34
0083,ASIAN18,34,49,15,40,46
0083,AMINDIAN18,6,6,0,6,6
0083,PISLAND18,1,0,-1,1,0
0083,OTHER18,1,0,-1,1,0
0083,OTHERMLT18,7,22,15,13,19
0084,PERSONS,1716,1786,70,1744,1772
0084,WHITE,1262,948,-314,1136,1011
0084,BLACK,296,588,292,413,530
0084,HISPANIC,65,79,14,71,76
0084,ASIAN,70,120,50,90,110
0084,AMINDIAN,16,10,-6,14,11
0084,PISLAND,0,0,0,0,0
0084,OTHER,2,4,2,3,4
0084,OTHERMLT,5,37,32,18,31
0084,PERSONS18,1359,1341,-18,1352,1345
0084,WHITE18,1064,774,-290,948,832
0084,BLACK18,188,427,239,284,379
0084,HISPANIC18,45,50,5,47,49
0084,ASIAN18,48,67,19,56,63
0084,AMINDIAN18,10,7,-3,9,8
0084,PISLAND18,0,0,0,0,0
0084,OTHER18,1,3,2,2,3
0084,OTHERMLT18,3,13,10,7,11
0085,PERSONS,1173,1223,50,1193,1213
0085,WHITE,1016,886,-130,964,912
0085,BLACK,104,239,135,158,212
0085,HISPANIC,22,41,19,30,37
0085,ASIAN,18,25,7,21,24
0085,AMINDIAN,8,5,-3,7,6
0085,PISLAND,0,0,0,0,0
0085,OTHER,3,0,-3,2,1
0085,OTHERMLT,2,27,25,12,22
0085,PERSONS18,946,1012,66,972,999
0085,WHITE18,872,787,-85,838,804
0085,BLACK18,44,156,112,89,134
0085,HISPANIC18,12,23,11,16,21
0085,ASIAN18,14,25,11,18,23
0085,AMINDIAN18,2,4,2,3,4
0085,PISLAND18,0,0,0,0,0
0085,OTHER18,2,0,-2,1,0
0085,OTHERMLT18,0,17,17,7,14
0086,PERSONS,1419,1482,63,1444,1469
0086,WHITE,1308,1196,-112,1263,1218
0086,BLACK,28,104,76,58,89
0086,HISPANIC,38,92,54,60,81
0086,ASIAN,31,43,12,36,41
0086,AMINDIAN,7,4,-3,6,5
0086,PISLAND,2,1,-1,2,1
0086,OTHER,4,2,-2,3,2
0086,OTHERMLT,1,40,39,17,32
0086,PERSONS18,1139,1113,-26,1129,1118
0086,WHITE18,1069,940,-129,1017,966
0086,BLACK18,18,74,56,40,63
0086,HISPANIC18,22,56,34,36,49
0086,ASIAN18,21,28,7,24,27
0086,AMINDIAN18,4,3,-1,4,3
0086,PISLAND18,1,1,0,1,1
0086,OTHER18,3,0,-3,2,1
0086,OTHERMLT18,1,11,10,5,9
0211,PERSONS,2912,2831,-81,2880,2847
0211,WHITE,556,366,-190,480,404
0211,BLACK,198,264,66,224,251
0211,HISPANIC,1994,2093,99,2034,2073
0211,ASIAN,84,41,-43,67,50
0211,AMINDIAN,46,23,-23,37,28
0211,PISLAND,0,0,0,0,0
0211,OTHER,16,0,-16,10,3
0211,OTHERMLT,18,44,26,28,39
0211,PERSONS18,1811,1742,-69,1783,1756
0211,WHITE18,458,286,-172,389,320
0211,BLACK18,82,146,64,108,133
0211,HISPANIC18,1175,1259,84,1209,1242
0211,ASIAN18,50,21,-29,38,27
0211,AMINDIAN18,27,16,-11,23,18
0211,PISLAND18,0,0,0,0,0
0211,OTHER18,12,0,-12,7,2
0211,OTHERMLT18,7,14,7,10,13
0219,PERSONS,1456,1710,254,1558,1659
0219,WHITE,1184,872,-312,1059,934
0219,BLACK,117,35,-82,84,51
0219,HISPANIC,95,686,591,331,568
0219,ASIAN,28,69,41,44,61
0219,AMINDIAN,25,10,-15,19,13
0219,PISLAND,0,0,0,0,0
0219,OTHER,4,8,4,6,7
0219,OTHERMLT,3,30,27,14,25
0219,PERSONS18,1162,1268,106,1204,1247
0219,WHITE18,1009,743,-266,903,796
0219,BLACK18,51,28,-23,42,33
0219,HISPANIC18,58,407,349,198,337
0219,ASIAN18,22,58,36,36,51
0219,AMINDIAN18,17,9,-8,14,11
0219,PISLAND18,0,0,0,0,0
0219,OTHER18,4,8,4,6,7
0219,OTHERMLT18,1,15,14,7,12
0022,PERSONS,1641,1690,49,1661,1680
0022,WHITE,256,117,-139,200,145
0022,BLACK,1298,1467,169,1366,1433
0022,HISPANIC,36,33,-3,35,34
0022,ASIAN,32,43,11,36,41
0022,AMINDIAN,8,7,-1,8,7
0022,PISLAND,0,0,0,0,0
0022,OTHER,3,0,-3,2,1
0022,OTHERMLT,8,23,15,14,20
0022,PERSONS18,923,933,10,927,931
0022,WHITE18,211,108,-103,170,129
0022,BLACK18,670,768,98,709,748
0022,HISPANIC18,16,19,3,17,18
0022,ASIAN18,16,25,9,20,23
0022,AMINDIAN18,4,3,-1,4,3
0022,PISLAND18,0,0,0,0,0
0022,OTHER18,1,0,-1,1,0
0022,OTHERMLT18,5,10,5,7,9
0220,PERSONS,2493,2594,101,2533,2574
0220,WHITE,1771,1149,-622,1522,1273
0220,BLACK,169,233,64,195,220
0220,HISPANIC,369,877,508,572,775
0220,ASIAN,116,244,128,167,218
0220,AMINDIAN,29,24,-5,27,25
0220,PISLAND,3,0,-3,2,1
0220,OTHER,21,0,-21,13,4
0220,OTHERMLT,15,67,52,36,57
0220,PERSONS18,2036,1958,-78,2005,1974
0220,WHITE18,1524,1019,-505,1322,1120
0220,BLACK18,113,167,54,135,156
0220,HISPANIC18,258,558,300,378,498
0220,ASIAN18,90,154,64,116,141
0220,AMINDIAN18,26,21,-5,24,22
0220,PISLAND18,3,0,-3,2,1
0220,OTHER18,13,0,-13,8,3
0220,OTHERMLT18,9,39,30,21,33
0221,PERSONS,1397,1847,450,1577,1757
0221,WHITE,1139,1208,69,1167,1194
0221,BLACK,56,109,53,77,98
0221,HISPANIC,157,458,301,277,398
0221,ASIAN,27,26,-1,27,26
0221,AMINDIAN,9,8,-1,9,8
0221,PISLAND,0,0,0,0,0
0221,OTHER,5,3,-2,4,3
0221,OTHERMLT,4,35,31,16,29
0221,PERSONS18,1127,1438,311,1251,1376
0221,WHITE18,976,1048,72,1005,1034
0221,BLACK18,24,64,40,40,56
0221,HISPANIC18,93,282,189,169,244
0221,ASIAN18,19,20,1,19,20
0221,AMINDIAN18,9,4,-5,7,5
0221,PISLAND18,0,0,0,0,0
0221,OTHER18,3,2,-1,3,2
0221,OTHERMLT18,3,18,15,9,15
0222,PERSONS,1619,1626,7,1622,1625
0222,WHITE,1363,1073,-290,1247,1131
0222,BLACK,26,50,24,36,45
0222,HISPANIC,143,420,277,254,365
0222,ASIAN,38,31,-7,35,32
0222,AMINDIAN,35,20,-15,29,23
0222,PISLAND,2,0,-2,1,0
0222,OTHER,8,1,-7,5,2
0222,OTHERMLT,4,31,27,15,26
0222,PERSONS18,1264,1254,-10,1260,1256
0222,WHITE18,1120,912,-208,1037,954
0222,BLACK18,9,30,21,17,26
0222,HISPANIC18,82,265,183,155,228
0222,ASIAN18,24,21,-3,23,22
0222,AMINDIAN18,19,12,-7,16,13
0222,PISLAND18,2,0,-2,1,0
0222,OTHER18,4,0,-4,2,1
0222,OTHERMLT18,4,14,10,8,12
0223,PERSONS,1618,1498,-120,1570,1522
0223,WHITE,1504,1284,-220,1416,1328
0223,BLACK,4,11,7,7,10
0223,HISPANIC,78,156,78,109,140
0223,ASIAN,8,9,1,8,9
0223,AMINDIAN,23,13,-10,19,15
0223,PISLAND,0,1,1,0,1
0223,OTHER,1,2,1,1,2
0223,OTHERMLT,0,22,22,9,18
0223,PERSONS18,1336,1234,-102,1295,1254
0223,WHITE18,1257,1101,-156,1195,1132
0223,BLACK18,2,8,6,4,7
0223,HISPANIC18,54,95,41,70,87
0223,ASIAN18,5,8,3,6,7
0223,AMINDIAN18,17,12,-5,15,13
0223,PISLAND18,0,1,1,0,1
0223,OTHER18,1,0,-1,1,0
0223,OTHERMLT18,0,9,9,4,7
0224,PERSONS,1549,1500,-49,1529,1510
0224,WHITE,1442,1305,-137,1387,1332
0224,BLACK,9,16,7,12,15
0224,HISPANIC,72,132,60,96,120
0224,ASIAN,9,22,13,14,19
0224,AMINDIAN,8,6,-2,7,6
0224,PISLAND,1,0,-1,1,0
0224,OTHER,3,1,-2,2,1
0224,OTHERMLT,5,18,13,10,15
0224,PERSONS18,1187,1189,2,1188,1189
0224,WHITE18,1119,1067,-52,1098,1077
0224,BLACK18,5,7,2,6,7
0224,HISPANIC18,46,84,38,61,76
0224,ASIAN18,5,18,13,10,15
0224,AMINDIAN18,4,4,0,4,4
0224,PISLAND18,1,0,-1,1,0
0224,OTHER18,3,1,-2,2,1
0224,OTHERMLT18,4,8,4,6,7
0225,PERSONS,1735,1818,83,1768,1801
0225,WHITE,1522,1298,-224,1432,1343
0225,BLACK,13,34,21,21,30
0225,HISPANIC,123,335,212,208,293
0225,ASIAN,49,90,41,65,82
0225,AMINDIAN,17,13,-4,15,14
0225,PISLAND,0,0,0,0,0
0225,OTHER,8,5,-3,7,6
0225,OTHERMLT,3,43,40,19,35
0225,PERSONS18,1400,1441,41,1416,1433
0225,WHITE18,1244,1099,-145,1186,1128
0225,BLACK18,9,29,20,17,25
0225,HISPANIC18,82,203,121,130,179
0225,ASIAN18,44,70,26,54,65
0225,AMINDIAN18,12,12,0,12,12
0225,PISLAND18,0,0,0,0,0
0225,OTHER18,7,4,-3,6,5
0225,OTHERMLT18,2,24,22,11,20
0226,PERSONS,2252,2523,271,2360,2469
0226,WHITE,1599,1283,-316,1473,1346
0226,BLACK,53,149,96,91,130
0226,HISPANIC,335,756,421,503,672
0226,ASIAN,140,229,89,176,211
0226,AMINDIAN,62,23,-39,46,31
0226,PISLAND,2,2,0,2,2
0226,OTHER,31,9,-22,22,13
0226,OTHERMLT,30,72,42,47,64
0226,PERSONS18,1743,1868,125,1793,1843
0226,WHITE18,1322,1062,-260,1218,1114
0226,BLACK18,39,114,75,69,99
0226,HISPANIC18,210,487,277,321,432
0226,ASIAN18,95,131,36,109,124
0226,AMINDIAN18,38,21,-17,31,24
0226,PISLAND18,2,2,0,2,2
0226,OTHER18,19,8,-11,15,10
0226,OTHERMLT18,18,43,25,28,38
0227,PERSONS,1198,1432,234,1292,1385
0227,WHITE,881,768,-113,836,791
0227,BLACK,35,81,46,53,72
0227,HISPANIC,149,302,153,210,271
0227,ASIAN,41,188,147,100,159
0227,AMINDIAN,29,5,-24,19,10
0227,PISLAND,0,0,0,0,0
0227,OTHER,60,0,-60,36,12
0227,OTHERMLT,3,88,85,37,71
0227,PERSONS18,896,933,37,911,926
0227,WHITE18,701,573,-128,650,599
0227,BLACK18,22,44,22,31,40
0227,HISPANIC18,93,168,75,123,153
0227,ASIAN18,28,104,76,58,89
0227,AMINDIAN18,15,3,-12,10,5
0227,PISLAND18,0,0,0,0,0
0227,OTHER18,35,0,-35,21,7
0227,OTHERMLT18,2,41,39,18,33
0228,PERSONS,2064,2075,11,2068,2073
0228,WHITE,1828,1498,-330,1696,1564
0228,BLACK,22,20,-2,21,20
0228,HISPANIC,139,356,217,226,313
0228,ASIAN,58,120,62,83,108
0228,AMINDIAN,7,15,8,10,13
0228,PISLAND,0,6,6,2,5
0228,OTHER,7,5,-2,6,5
0228,OTHERMLT,3,55,52,24,45
0228,PERSONS18,1642,1580,-62,1617,1592
0228,WHITE18,1508,1208,-300,1388,1268
0228,BLACK18,7,14,7,10,13
0228,HISPANIC18,76,227,151,136,197
0228,ASIAN18,43,84,41,59,76
0228,AMINDIAN18,3,12,9,7,10
0228,PISLAND18,0,2,2,1,2
0228,OTHER18,2,3,1,2,3
0228,OTHERMLT18,3,30,27,14,25
0229,PERSONS,2042,2107,65,2068,2094
0229,WHITE,1687,1517,-170,1619,1551
0229,BLACK,32,47,15,38,44
0229,HISPANIC,169,316,147,228,287
0229,ASIAN,103,140,37,118,133
0229,AMINDIAN,21,17,-4,19,18
0229,PISLAND,0,3,3,1,2
0229,OTHER,16,3,-13,11,6
0229,OTHERMLT,14,64,50,34,54
0229,PERSONS18,1580,1570,-10,1576,1572
0229,WHITE18,1349,1201,-148,1290,1231
0229,BLACK18,20,28,8,23,26
0229,HISPANIC18,116,206,90,152,188
0229,ASIAN18,64,88,24,74,83
0229,AMINDIAN18,12,12,0,12,12
0229,PISLAND18,0,3,3,1,2
0229,OTHER18,12,1,-11,8,3
0229,OTHERMLT18,7,31,24,17,26
0023,PERSONS,1743,1602,-141,1687,1630
0023,WHITE,604,330,-274,494,385
0023,BLACK,994,1115,121,1042,1091
0023,HISPANIC,62,72,10,66,70
0023,ASIAN,46,48,2,47,48
0023,AMINDIAN,15,1,-14,9,4
0023,PISLAND,0,0,0,0,0
0023,OTHER,7,1,-6,5,2
0023,OTHERMLT,15,35,20,23,31
0023,PERSONS18,1140,1139,-1,1140,1139
0023,WHITE18,483,299,-184,409,336
0023,BLACK18,594,747,153,655,716
0023,HISPANIC18,32,41,9,36,39
0023,ASIAN18,15,32,17,22,29
0023,AMINDIAN18,6,0,-6,4,1
0023,PISLAND18,0,0,0,0,0
0023,OTHER18,3,1,-2,2,1
0023,OTHERMLT18,7,19,12,12,17
0230,PERSONS,2003,2067,64,2029,2054
0230,WHITE,1790,1679,-111,1746,1701
0230,BLACK,5,14,9,9,12
0230,HISPANIC,130,270,140,186,242
0230,ASIAN,50,53,3,51,52
0230,AMINDIAN,9,15,6,11,14
0230,PISLAND,4,0,-4,2,1
0230,OTHER,14,0,-14,8,3
0230,OTHERMLT,1,36,35,15,29
0230,PERSONS18,1543,1535,-8,1540,1537
0230,WHITE18,1426,1302,-124,1376,1327
0230,BLACK18,2,11,9,6,9
0230,HISPANIC18,72,167,95,110,148
0230,ASIAN18,31,37,6,33,36
0230,AMINDIAN18,3,8,5,5,7
0230,PISLAND18,2,0,-2,1,0
0230,OTHER18,6,0,-6,4,1
0230,OTHERMLT18,1,10,9,5,8
0231,PERSONS,3704,3717,13,3709,3714
0231,WHITE,3228,2861,-367,3081,2934
0231,BLACK,53,100,47,72,91
0231,HISPANIC,285,533,248,384,483
0231,ASIAN,80,118,38,95,110
0231,AMINDIAN,29,20,-9,25,22
0231,PISLAND,2,1,-1,2,1
0231,OTHER,23,8,-15,17,11
0231,OTHERMLT,4,76,72,33,62
0231,PERSONS18,2927,2871,-56,2905,2882
0231,WHITE18,2652,2360,-292,2535,2418
0231,BLACK18,25,77,52,46,67
0231,HISPANIC18,171,303,132,224,277
0231,ASIAN18,48,78,30,60,72
0231,AMINDIAN18,18,14,-4,16,15
0231,PISLAND18,1,1,0,1,1
0231,OTHER18,9,3,-6,7,4
0231,OTHERMLT18,3,35,32,16,29
0232,PERSONS,2548,2463,-85,2514,2480
0232,WHITE,2205,1875,-330,2073,1941
0232,BLACK,27,51,24,37,46
0232,HISPANIC,226,348,122,275,324
0232,ASIAN,54,106,52,75,96
0232,AMINDIAN,23,27,4,25,26
0232,PISLAND,0,1,1,0,1
0232,OTHER,8,2,-6,6,3
0232,OTHERMLT,5,53,48,24,43
0232,PERSONS18,2046,1909,-137,1991,1936
0232,WHITE18,1836,1551,-285,1722,1608
0232,BLACK18,17,36,19,25,32
0232,HISPANIC18,133,203,70,161,189
0232,ASIAN18,34,70,36,48,63
0232,AMINDIAN18,18,18,0,18,18
0232,PISLAND18,0,1,1,0,1
0232,OTHER18,5,1,-4,3,2
0232,OTHERMLT18,3,29,26,13,24
0233,PERSONS,1611,1635,24,1621,1630
0233,WHITE,1402,1270,-132,1349,1296
0233,BLACK,2,23,21,10,19
0233,HISPANIC,110,232,122,159,208
0233,ASIAN,36,79,43,53,70
0233,AMINDIAN,35,14,-21,27,18
0233,PISLAND,0,2,2,1,2
0233,OTHER,13,0,-13,8,3
0233,OTHERMLT,13,15,2,14,15
0233,PERSONS18,1249,1242,-7,1246,1243
0233,WHITE18,1118,1003,-115,1072,1026
0233,BLACK18,2,17,15,8,14
0233,HISPANIC18,61,151,90,97,133
0233,ASIAN18,31,49,18,38,45
0233,AMINDIAN18,24,11,-13,19,14
0233,PISLAND18,0,2,2,1,2
0233,OTHER18,5,0,-5,3,1
0233,OTHERMLT18,8,9,1,8,9
0234,PERSONS,1482,1578,96,1520,1559
0234,WHITE,1275,1177,-98,1236,1197
0234,BLACK,14,25,11,18,23
0234,HISPANIC,142,305,163,207,272
0234,ASIAN,17,22,5,19,21
0234,AMINDIAN,11,9,-2,10,9
0234,PISLAND,3,0,-3,2,1
0234,OTHER,19,2,-17,12,5
0234,OTHERMLT,1,38,37,16,31
0234,PERSONS18,1162,1191,29,1174,1185
0234,WHITE18,1034,940,-94,996,959
0234,BLACK18,8,16,8,11,14
0234,HISPANIC18,89,189,100,129,169
0234,ASIAN18,10,15,5,12,14
0234,AMINDIAN18,7,8,1,7,8
0234,PISLAND18,3,0,-3,2,1
0234,OTHER18,10,1,-9,6,3
0234,OTHERMLT18,1,22,21,9,18
0239,PERSONS,1361,1298,-63,1336,1311
0239,WHITE,1161,1082,-79,1129,1098
0239,BLACK,20,19,-1,20,19
0239,HISPANIC,119,136,17,126,133
0239,ASIAN,15,11,-4,13,12
0239,AMINDIAN,24,6,-18,17,10
0239,PISLAND,1,1,0,1,1
0239,OTHER,11,0,-11,7,2
0239,OTHERMLT,10,43,33,23,36
0239,PERSONS18,1079,1047,-32,1066,1053
0239,WHITE18,969,927,-42,952,935
0239,BLACK18,10,9,-1,10,9
0239,HISPANIC18,61,83,22,70,79
0239,ASIAN18,10,9,-1,10,9
0239,AMINDIAN18,17,5,-12,12,7
0239,PISLAND18,1,1,0,1,1
0239,OTHER18,8,0,-8,5,2
0239,OTHERMLT18,3,13,10,7,11
0024,PERSONS,1599,1794,195,1677,1755
0024,WHITE,421,214,-207,338,255
0024,BLACK,827,987,160,891,955
0024,HISPANIC,50,61,11,54,59
0024,ASIAN,266,494,228,357,448
0024,AMINDIAN,2,4,2,3,4
0024,PISLAND,0,0,0,0,0
0024,OTHER,5,0,-5,3,1
0024,OTHERMLT,28,34,6,30,33
0024,PERSONS18,1061,1176,115,1107,1153
0024,WHITE18,369,193,-176,299,228
0024,BLACK18,523,666,143,580,637
0024,HISPANIC18,28,37,9,32,35
0024,ASIAN18,121,260,139,177,232
0024,AMINDIAN18,2,2,0,2,2
0024,PISLAND18,0,0,0,0,0
0024,OTHER18,3,0,-3,2,1
0024,OTHERMLT18,15,18,3,16,17
0240,PERSONS,1395,1292,-103,1354,1313
0240,WHITE,1208,1055,-153,1147,1086
0240,BLACK,29,43,14,35,40
0240,HISPANIC,118,138,20,126,134
0240,ASIAN,13,13,0,13,13
0240,AMINDIAN,26,10,-16,20,13
0240,PISLAND,1,3,2,2,3
0240,OTHER,0,0,0,0,0
0240,OTHERMLT,0,30,30,12,24
0240,PERSONS18,1090,1060,-30,1078,1066
0240,WHITE18,981,913,-68,954,927
0240,BLACK18,14,17,3,15,16
0240,HISPANIC18,67,91,24,77,86
0240,ASIAN18,6,11,5,8,10
0240,AMINDIAN18,21,8,-13,16,11
0240,PISLAND18,1,3,2,2,3
0240,OTHER18,0,0,0,0,0
0240,OTHERMLT18,0,17,17,7,14
0241,PERSONS,1058,1060,2,1059,1060
0241,WHITE,872,806,-66,846,819
0241,BLACK,12,24,12,17,22
0241,HISPANIC,151,182,31,163,176
0241,ASIAN,12,7,-5,10,8
0241,AMINDIAN,9,7,-2,8,7
0241,PISLAND,1,0,-1,1,0
0241,OTHER,1,0,-1,1,0
0241,OTHERMLT,0,34,34,14,27
0241,PERSONS18,825,832,7,828,831
0241,WHITE18,717,684,-33,704,691
0241,BLACK18,8,14,6,10,13
0241,HISPANIC18,84,107,23,93,102
0241,ASIAN18,8,6,-2,7,6
0241,AMINDIAN18,6,7,1,6,7
0241,PISLAND18,1,0,-1,1,0
0241,OTHER18,1,0,-1,1,0
0241,OTHERMLT18,0,14,14,6,11
0242,PERSONS,1289,1485,196,1367,1446
0242,WHITE,1052,825,-227,961,870
0242,BLACK,10,13,3,11,12
0242,HISPANIC,194,602,408,357,520
0242,ASIAN,19,9,-10,15,11
0242,AMINDIAN,12,13,1,12,13
0242,PISLAND,0,0,0,0,0
0242,OTHER,1,2,1,1,2
0242,OTHERMLT,1,21,20,9,17
0242,PERSONS18,1011,1087,76,1041,1072
0242,WHITE18,873,692,-181,801,728
0242,BLACK18,6,10,4,8,9
0242,HISPANIC18,107,353,246,205,304
0242,ASIAN18,15,6,-9,11,8
0242,AMINDIAN18,9,11,2,10,11
0242,PISLAND18,0,0,0,0,0
0242,OTHER18,0,2,2,1,2
0242,OTHERMLT18,1,13,12,6,11
0243,PERSONS,1687,1898,211,1771,1856
0243,WHITE,1088,584,-504,886,685
0243,BLACK,22,38,16,28,35
0243,HISPANIC,474,1226,752,775,1076
0243,ASIAN,52,15,-37,37,22
0243,AMINDIAN,35,16,-19,27,20
0243,PISLAND,1,2,1,1,2
0243,OTHER,11,3,-8,8,5
0243,OTHERMLT,4,14,10,8,12
0243,PERSONS18,1198,1284,86,1232,1267
0243,WHITE18,853,502,-351,713,572
0243,BLACK18,10,24,14,16,21
0243,HISPANIC18,279,726,447,458,637
0243,ASIAN18,25,10,-15,19,13
0243,AMINDIAN18,21,11,-10,17,13
0243,PISLAND18,0,2,2,1,2
0243,OTHER18,7,1,-6,5,2
0243,OTHERMLT18,3,8,5,5,7
0244,PERSONS,1903,2255,352,2044,2185
0244,WHITE,1107,549,-558,884,661
0244,BLACK,47,60,13,52,57
0244,HISPANIC,634,1548,914,1000,1365
0244,ASIAN,58,38,-20,50,42
0244,AMINDIAN,40,25,-15,34,28
0244,PISLAND,0,0,0,0,0
0244,OTHER,16,1,-15,10,4
0244,OTHERMLT,1,34,33,14,27
0244,PERSONS18,1343,1482,139,1399,1454
0244,WHITE18,870,465,-405,708,546
0244,BLACK18,22,34,12,27,32
0244,HISPANIC18,378,921,543,595,812
0244,ASIAN18,38,29,-9,34,31
0244,AMINDIAN18,26,22,-4,24,23
0244,PISLAND18,0,0,0,0,0
0244,OTHER18,9,1,-8,6,3
0244,OTHERMLT18,0,10,10,4,8
0245,PERSONS,1547,1705,158,1610,1673
0245,WHITE,1168,782,-386,1014,859
0245,BLACK,49,143,94,87,124
0245,HISPANIC,267,730,463,452,637
0245,ASIAN,33,18,-15,27,21
0245,AMINDIAN,12,5,-7,9,6
0245,PISLAND,4,1,-3,3,2
0245,OTHER,5,2,-3,4,3
0245,OTHERMLT,9,24,15,15,21
0245,PERSONS18,1203,1250,47,1222,1241
0245,WHITE18,987,700,-287,872,757
0245,BLACK18,29,87,58,52,75
0245,HISPANIC18,154,430,276,264,375
0245,ASIAN18,18,15,-3,17,16
0245,AMINDIAN18,6,2,-4,4,3
0245,PISLAND18,2,0,-2,1,0
0245,OTHER18,3,1,-2,2,1
0245,OTHERMLT18,4,15,11,8,13
0246,PERSONS,1059,1078,19,1067,1074
0246,WHITE,583,307,-276,473,362
0246,BLACK,107,186,79,139,170
0246,HISPANIC,321,549,228,412,503
0246,ASIAN,13,4,-9,9,6
0246,AMINDIAN,21,14,-7,18,15
0246,PISLAND,0,0,0,0,0
0246,OTHER,7,0,-7,4,1
0246,OTHERMLT,7,18,11,11,16
0246,PERSONS18,747,747,0,747,747
0246,WHITE18,482,279,-203,401,320
0246,BLACK18,59,107,48,78,97
0246,HISPANIC18,175,344,169,243,310
0246,ASIAN18,13,4,-9,9,6
0246,AMINDIAN18,12,5,-7,9,6
0246,PISLAND18,0,0,0,0,0
0246,OTHER18,3,0,-3,2,1
0246,OTHERMLT18,3,8,5,5,7
0247,PERSONS,1055,1248,193,1132,1209
0247,WHITE,888,695,-193,811,734
0247,BLACK,7,16,9,11,14
0247,HISPANIC,122,490,368,269,416
0247,ASIAN,11,12,1,11,12
0247,AMINDIAN,21,14,-7,18,15
0247,PISLAND,0,0,0,0,0
0247,OTHER,5,4,-1,5,4
0247,OTHERMLT,1,17,16,7,14
0247,PERSONS18,828,917,89,864,899
0247,WHITE18,722,577,-145,664,606
0247,BLACK18,5,8,3,6,7
0247,HISPANIC18,72,300,228,163,254
0247,ASIAN18,8,9,1,8,9
0247,AMINDIAN18,16,13,-3,15,14
0247,PISLAND18,0,0,0,0,0
0247,OTHER18,5,1,-4,3,2
0247,OTHERMLT18,0,9,9,4,7
0248,PERSONS,1312,1672,360,1456,1600
0248,WHITE,1103,683,-420,935,767
0248,BLACK,13,39,26,23,34
0248,HISPANIC,161,878,717,448,735
0248,ASIAN,8,39,31,20,33
0248,AMINDIAN,22,8,-14,16,11
0248,PISLAND,0,2,2,1,2
0248,OTHER,5,0,-5,3,1
0248,OTHERMLT,0,23,23,9,18
0248,PERSONS18,1012,1159,147,1071,1130
0248,WHITE18,887,566,-321,759,630
0248,BLACK18,5,24,19,13,20
0248,HISPANIC18,94,527,433,267,440
0248,ASIAN18,8,23,15,14,20
0248,AMINDIAN18,16,8,-8,13,10
0248,PISLAND18,0,2,2,1,2
0248,OTHER18,2,0,-2,1,0
0248,OTHERMLT18,0,9,9,4,7
0249,PERSONS,1277,1268,-9,1273,1270
0249,WHITE,1098,986,-112,1053,1008
0249,BLACK,16,17,1,16,17
0249,HISPANIC,118,188,70,146,174
0249,ASIAN,20,13,-7,17,14
0249,AMINDIAN,20,32,12,25,30
0249,PISLAND,0,1,1,0,1
0249,OTHER,3,1,-2,2,1
0249,OTHERMLT,2,30,28,13,24
0249,PERSONS18,1041,1029,-12,1036,1031
0249,WHITE18,923,848,-75,893,863
0249,BLACK18,9,13,4,11,12
0249,HISPANIC18,75,124,49,95,114
0249,ASIAN18,14,7,-7,11,8
0249,AMINDIAN18,17,21,4,19,20
0249,PISLAND18,0,1,1,0,1
0249,OTHER18,1,0,-1,1,0
0249,OTHERMLT18,2,15,13,7,12
0025,PERSONS,1996,1730,-266,1890,1783
0025,WHITE,762,352,-410,598,434
0025,BLACK,1019,1089,70,1047,1075
0025,HISPANIC,44,67,23,53,62
0025,ASIAN,133,191,58,156,179
0025,AMINDIAN,13,6,-7,10,7
0025,PISLAND,0,0,0,0,0
0025,OTHER,2,0,-2,1,0
0025,OTHERMLT,23,25,2,24,25
0025,PERSONS18,1306,1146,-160,1242,1178
0025,WHITE18,621,297,-324,491,362
0025,BLACK18,577,685,108,620,663
0025,HISPANIC18,27,37,10,31,35
0025,ASIAN18,65,110,45,83,101
0025,AMINDIAN18,6,5,-1,6,5
0025,PISLAND18,0,0,0,0,0
0025,OTHER18,1,0,-1,1,0
0025,OTHERMLT18,9,12,3,10,11
0250,PERSONS,1497,1453,-44,1479,1462
0250,WHITE,1326,1175,-151,1266,1205
0250,BLACK,26,38,12,31,36
0250,HISPANIC,112,170,58,135,158
0250,ASIAN,4,18,14,10,15
0250,AMINDIAN,25,20,-5,23,21
0250,PISLAND,0,0,0,0,0
0250,OTHER,3,1,-2,2,1
0250,OTHERMLT,1,31,30,13,25
0250,PERSONS18,1190,1213,23,1199,1208
0250,WHITE18,1086,1032,-54,1064,1043
0250,BLACK18,13,24,11,17,22
0250,HISPANIC18,62,113,51,82,103
0250,ASIAN18,4,11,7,7,10
0250,AMINDIAN18,22,16,-6,20,17
0250,PISLAND18,0,0,0,0,0
0250,OTHER18,3,0,-3,2,1
0250,OTHERMLT18,0,17,17,7,14
0251,PERSONS,1638,1546,-92,1601,1564
0251,WHITE,1459,1325,-134,1405,1352
0251,BLACK,14,31,17,21,28
0251,HISPANIC,118,143,25,128,138
0251,ASIAN,16,3,-13,11,6
0251,AMINDIAN,24,16,-8,21,18
0251,PISLAND,1,0,-1,1,0
0251,OTHER,2,1,-1,2,1
0251,OTHERMLT,4,27,23,13,22
0251,PERSONS18,1274,1291,17,1281,1288
0251,WHITE18,1169,1131,-38,1154,1139
0251,BLACK18,5,27,22,14,23
0251,HISPANIC18,69,97,28,80,91
0251,ASIAN18,10,2,-8,7,4
0251,AMINDIAN18,17,13,-4,15,14
0251,PISLAND18,1,0,-1,1,0
0251,OTHER18,1,0,-1,1,0
0251,OTHERMLT18,2,21,19,10,17
0252,PERSONS,1528,1411,-117,1481,1434
0252,WHITE,1378,1235,-143,1321,1264
0252,BLACK,13,23,10,17,21
0252,HISPANIC,100,101,1,100,101
0252,ASIAN,18,18,0,18,18
0252,AMINDIAN,15,5,-10,11,7
0252,PISLAND,0,0,0,0,0
0252,OTHER,2,0,-2,1,0
0252,OTHERMLT,2,29,27,13,24
0252,PERSONS18,1239,1194,-45,1221,1203
0252,WHITE18,1141,1081,-60,1117,1093
0252,BLACK18,5,10,5,7,9
0252,HISPANIC18,69,67,-2,68,67
0252,ASIAN18,8,16,8,11,14
0252,AMINDIAN18,12,5,-7,9,6
0252,PISLAND18,0,0,0,0,0
0252,OTHER18,2,0,-2,1,0
0252,OTHERMLT18,2,15,13,7,12
0257,PERSONS,1418,1358,-60,1394,1370
0257,WHITE,1266,1077,-189,1190,1115
0257,BLACK,25,37,12,30,35
0257,HISPANIC,87,188,101,127,168
0257,ASIAN,22,19,-3,21,20
0257,AMINDIAN,16,8,-8,13,10
0257,PISLAND,1,0,-1,1,0
0257,OTHER,1,0,-1,1,0
0257,OTHERMLT,0,29,29,12,23
0257,PERSONS18,1100,1035,-65,1074,1048
0257,WHITE18,1012,882,-130,960,908
0257,BLACK18,9,20,11,13,18
0257,HISPANIC18,52,106,54,74,95
0257,ASIAN18,14,9,-5,12,10
0257,AMINDIAN18,12,6,-6,10,7
0257,PISLAND18,1,0,-1,1,0
0257,OTHER18,0,0,0,0,0
0257,OTHERMLT18,0,12,12,5,10
0258,PERSONS,2268,2434,166,2334,2401
0258,WHITE,1195,593,-602,954,713
0258,BLACK,790,1592,802,1111,1432
0258,HISPANIC,100,69,-31,88,75
0258,ASIAN,130,86,-44,112,95
0258,AMINDIAN,19,4,-15,13,7
0258,PISLAND,2,2,0,2,2
0258,OTHER,8,3,-5,6,4
0258,OTHERMLT,24,85,61,48,73
0258,PERSONS18,1840,1787,-53,1819,1798
0258,WHITE18,1064,547,-517,857,650
0258,BLACK18,562,1064,502,763,964
0258,HISPANIC18,62,50,-12,57,52
0258,ASIAN18,112,73,-39,96,81
0258,AMINDIAN18,14,2,-12,9,4
0258,PISLAND18,2,2,0,2,2
0258,OTHER18,7,3,-4,5,4
0258,OTHERMLT18,17,46,29,29,40
0259,PERSONS,2462,2388,-74,2432,2403
0259,WHITE,1008,757,-251,908,807
0259,BLACK,1214,1392,178,1285,1356
0259,HISPANIC,84,95,11,88,93
0259,ASIAN,119,89,-30,107,95
0259,AMINDIAN,11,8,-3,10,9
0259,PISLAND,2,0,-2,1,0
0259,OTHER,8,0,-8,5,2
0259,OTHERMLT,16,47,31,28,41
0259,PERSONS18,1740,1717,-23,1731,1722
0259,WHITE18,930,720,-210,846,762
0259,BLACK18,667,867,200,747,827
0259,HISPANIC18,50,54,4,52,53
0259,ASIAN18,70,51,-19,62,55
0259,AMINDIAN18,8,6,-2,7,6
0259,PISLAND18,0,0,0,0,0
0259,OTHER18,8,0,-8,5,2
0259,OTHERMLT18,7,19,12,12,17
0026,PERSONS,2569,2718,149,2629,2688
0026,WHITE,1111,524,-587,876,641
0026,BLACK,1240,1839,599,1480,1719
0026,HISPANIC,77,97,20,85,93
0026,ASIAN,97,138,41,113,130
0026,AMINDIAN,29,8,-21,21,12
0026,PISLAND,0,1,1,0,1
0026,OTHER,4,18,14,10,15
0026,OTHERMLT,11,93,82,44,77
0026,PERSONS18,1728,1767,39,1744,1759
0026,WHITE18,919,453,-466,733,546
0026,BLACK18,698,1138,440,874,1050
0026,HISPANIC18,38,50,12,43,48
0026,ASIAN18,46,82,36,60,75
0026,AMINDIAN18,21,6,-15,15,9
0026,PISLAND18,0,1,1,0,1
0026,OTHER18,1,5,4,3,4
0026,OTHERMLT18,5,32,27,16,27
0260,PERSONS,1884,1642,-242,1787,1690
0260,WHITE,267,144,-123,218,169
0260,BLACK,1475,1287,-188,1400,1325
0260,HISPANIC,62,149,87,97,132
0260,ASIAN,26,7,-19,18,11
0260,AMINDIAN,20,0,-20,12,4
0260,PISLAND,0,0,0,0,0
0260,OTHER,22,2,-20,14,6
0260,OTHERMLT,12,53,41,28,45
0260,PERSONS18,888,862,-26,878,867
0260,WHITE18,210,116,-94,172,135
0260,BLACK18,608,614,6,610,613
0260,HISPANIC18,29,100,71,57,86
0260,ASIAN18,16,7,-9,12,9
0260,AMINDIAN18,8,0,-8,5,2
0260,PISLAND18,0,0,0,0,0
0260,OTHER18,9,1,-8,6,3
0260,OTHERMLT18,8,24,16,14,21
0261,PERSONS,3017,3808,791,3333,3650
0261,WHITE,1075,959,-116,1029,982
0261,BLACK,1631,1872,241,1727,1824
0261,HISPANIC,160,691,531,372,585
0261,ASIAN,80,155,75,110,140
0261,AMINDIAN,18,8,-10,14,10
0261,PISLAND,1,0,-1,1,0
0261,OTHER,9,16,7,12,15
0261,OTHERMLT,43,107,64,69,94
0261,PERSONS18,2063,2604,541,2279,2496
0261,WHITE18,973,860,-113,928,883
0261,BLACK18,890,1138,248,989,1088
0261,HISPANIC18,104,426,322,233,362
0261,ASIAN18,54,120,66,80,107
0261,AMINDIAN18,10,6,-4,8,7
0261,PISLAND18,1,0,-1,1,0
0261,OTHER18,6,4,-2,5,4
0261,OTHERMLT18,25,50,25,35,45
0263,PERSONS,1557,1574,17,1564,1571
0263,WHITE,1123,614,-509,919,716
0263,BLACK,307,724,417,474,641
0263,HISPANIC,78,116,38,93,108
0263,ASIAN,23,31,8,26,29
0263,AMINDIAN,14,18,4,16,17
0263,PISLAND,3,0,-3,2,1
0263,OTHER,4,3,-1,4,3
0263,OTHERMLT,5,68,63,30,55
0263,PERSONS18,1070,1042,-28,1059,1048
0263,WHITE18,830,512,-318,703,576
0263,BLACK18,167,403,236,261,356
0263,HISPANIC18,39,72,33,52,65
0263,ASIAN18,18,20,2,19,20
0263,AMINDIAN18,9,13,4,11,12
0263,PISLAND18,2,0,-2,1,0
0263,OTHER18,1,1,0,1,1
0263,OTHERMLT18,4,21,17,11,18
0264,PERSONS,3380,3703,323,3509,3638
0264,WHITE,1980,1290,-690,1704,1428
0264,BLACK,1082,1962,880,1434,1786
0264,HISPANIC,140,97,-43,123,106
0264,ASIAN,112,230,118,159,206
0264,AMINDIAN,32,19,-13,27,22
0264,PISLAND,0,8,8,3,6
0264,OTHER,9,5,-4,7,6
0264,OTHERMLT,25,92,67,52,79
0264,PERSONS18,2497,2593,96,2535,2574
0264,WHITE18,1639,1120,-519,1431,1224
0264,BLACK18,662,1181,519,870,1077
0264,HISPANIC18,86,62,-24,76,67
0264,ASIAN18,73,171,98,112,151
0264,AMINDIAN18,20,15,-5,18,16
0264,PISLAND18,0,5,5,2,4
0264,OTHER18,5,3,-2,4,3
0264,OTHERMLT18,12,36,24,22,31
0265,PERSONS,1821,1774,-47,1802,1783
0265,WHITE,867,445,-422,698,529
0265,BLACK,855,1173,318,982,1109
0265,HISPANIC,43,66,23,52,61
0265,ASIAN,23,35,12,28,33
0265,AMINDIAN,7,12,5,9,11
0265,PISLAND,0,0,0,0,0
0265,OTHER,9,5,-4,7,6
0265,OTHERMLT,17,38,21,25,34
0265,PERSONS18,1430,1366,-64,1404,1379
0265,WHITE18,787,420,-367,640,493
0265,BLACK18,581,866,285,695,809
0265,HISPANIC18,32,37,5,34,36
0265,ASIAN18,12,21,9,16,19
0265,AMINDIAN18,4,6,2,5,6
0265,PISLAND18,0,0,0,0,0
0265,OTHER18,5,4,-1,5,4
0265,OTHERMLT18,9,12,3,10,11
0266,PERSONS,1207,1679,472,1396,1585
0266,WHITE,518,452,-66,492,465
0266,BLACK,594,1038,444,772,949
0266,HISPANIC,39,94,55,61,83
0266,ASIAN,31,54,23,40,49
0266,AMINDIAN,6,1,-5,4,2
0266,PISLAND,0,1,1,0,1
0266,OTHER,9,3,-6,7,4
0266,OTHERMLT,10,36,26,20,31
0266,PERSONS18,811,1103,292,928,1045
0266,WHITE18,392,350,-42,375,358
0266,BLACK18,351,648,297,470,589
0266,HISPANIC18,25,53,28,36,47
0266,ASIAN18,27,36,9,31,34
0266,AMINDIAN18,5,1,-4,3,2
0266,PISLAND18,0,1,1,0,1
0266,OTHER18,6,0,-6,4,1
0266,OTHERMLT18,5,14,9,9,12
0267,PERSONS,1900,2081,181,1972,2045
0267,WHITE,1070,814,-256,968,865
0267,BLACK,658,1004,346,796,935
0267,HISPANIC,60,81,21,68,77
0267,ASIAN,58,93,35,72,86
0267,AMINDIAN,11,6,-5,9,7
0267,PISLAND,0,1,1,0,1
0267,OTHER,21,6,-15,15,9
0267,OTHERMLT,22,76,54,44,65
0267,PERSONS18,1400,1602,202,1481,1562
0267,WHITE18,846,690,-156,784,721
0267,BLACK18,459,767,308,582,705
0267,HISPANIC18,31,48,17,38,45
0267,ASIAN18,36,58,22,45,54
0267,AMINDIAN18,6,5,-1,6,5
0267,PISLAND18,0,1,1,0,1
0267,OTHER18,12,0,-12,7,2
0267,OTHERMLT18,10,33,23,19,28
0268,PERSONS,1336,1321,-15,1330,1324
0268,WHITE,941,699,-242,844,747
0268,BLACK,302,400,98,341,380
0268,HISPANIC,40,49,9,44,47
0268,ASIAN,41,131,90,77,113
0268,AMINDIAN,7,6,-1,7,6
0268,PISLAND,0,0,0,0,0
0268,OTHER,3,6,3,4,5
0268,OTHERMLT,2,30,28,13,24
0268,PERSONS18,1008,1002,-6,1006,1003
0268,WHITE18,757,591,-166,691,624
0268,BLACK18,196,283,87,231,266
0268,HISPANIC18,21,31,10,25,29
0268,ASIAN18,24,76,52,45,66
0268,AMINDIAN18,6,4,-2,5,4
0268,PISLAND18,0,0,0,0,0
0268,OTHER18,2,3,1,2,3
0268,OTHERMLT18,2,14,12,7,12
0269,PERSONS,2900,2944,44,2918,2935
0269,WHITE,1559,908,-651,1299,1038
0269,BLACK,1091,1545,454,1273,1454
0269,HISPANIC,87,119,32,100,113
0269,ASIAN,104,302,198,183,262
0269,AMINDIAN,26,5,-21,18,9
0269,PISLAND,0,0,0,0,0
0269,OTHER,15,3,-12,10,5
0269,OTHERMLT,18,62,44,36,53
0269,PERSONS18,2144,2147,3,2145,2146
0269,WHITE18,1284,784,-500,1084,884
0269,BLACK18,713,1070,357,856,999
0269,HISPANIC18,50,78,28,61,72
0269,ASIAN18,61,186,125,111,161
0269,AMINDIAN18,16,4,-12,11,6
0269,PISLAND18,0,0,0,0,0
0269,OTHER18,7,0,-7,4,1
0269,OTHERMLT18,13,25,12,18,23
0027,PERSONS,2691,2640,-51,2671,2650
0027,WHITE,1268,658,-610,1024,780
0027,BLACK,1177,1634,457,1360,1543
0027,HISPANIC,86,110,24,96,105
0027,ASIAN,93,165,72,122,151
0027,AMINDIAN,25,10,-15,19,13
0027,PISLAND,2,1,-1,2,1
0027,OTHER,13,3,-10,9,5
0027,OTHERMLT,27,59,32,40,53
0027,PERSONS18,1946,1864,-82,1913,1880
0027,WHITE18,1052,578,-474,862,673
0027,BLACK18,738,1092,354,880,1021
0027,HISPANIC18,54,67,13,59,64
0027,ASIAN18,62,90,28,73,84
0027,AMINDIAN18,16,8,-8,13,10
0027,PISLAND18,2,1,-1,2,1
0027,OTHER18,8,3,-5,6,4
0027,OTHERMLT18,14,25,11,18,23
0270,PERSONS,2236,2244,8,2239,2242
0270,WHITE,495,256,-239,399,304
0270,BLACK,1430,1298,-132,1377,1324
0270,HISPANIC,80,64,-16,74,67
0270,ASIAN,191,536,345,329,467
0270,AMINDIAN,15,3,-12,10,5
0270,PISLAND,0,0,0,0,0
0270,OTHER,3,0,-3,2,1
0270,OTHERMLT,22,87,65,48,74
0270,PERSONS18,1309,1369,60,1333,1357
0270,WHITE18,412,225,-187,337,262
0270,BLACK18,745,802,57,768,791
0270,HISPANIC18,60,34,-26,50,39
0270,ASIAN18,74,275,201,154,235
0270,AMINDIAN18,8,2,-6,6,3
0270,PISLAND18,0,0,0,0,0
0270,OTHER18,1,0,-1,1,0
0270,OTHERMLT18,9,31,22,18,27
0271,PERSONS,3567,3421,-146,3509,3450
0271,WHITE,1513,678,-835,1179,845
0271,BLACK,1812,2331,519,2020,2227
0271,HISPANIC,123,146,23,132,141
0271,ASIAN,58,139,81,90,123
0271,AMINDIAN,24,5,-19,16,9
0271,PISLAND,5,1,-4,3,2
0271,OTHER,10,1,-9,6,3
0271,OTHERMLT,22,120,98,61,100
0271,PERSONS18,2343,2208,-135,2289,2235
0271,WHITE18,1270,615,-655,1008,746
0271,BLACK18,930,1373,443,1107,1284
0271,HISPANIC18,72,83,11,76,81
0271,ASIAN18,34,92,58,57,80
0271,AMINDIAN18,16,4,-12,11,6
0271,PISLAND18,3,1,-2,2,1
0271,OTHER18,2,1,-1,2,1
0271,OTHERMLT18,16,39,23,25,34
0277,PERSONS,1403,1360,-43,1386,1369
0277,WHITE,1195,1059,-136,1141,1086
0277,BLACK,91,168,77,122,153
0277,HISPANIC,70,67,-3,69,68
0277,ASIAN,19,22,3,20,21
0277,AMINDIAN,19,11,-8,16,13
0277,PISLAND,0,0,0,0,0
0277,OTHER,5,0,-5,3,1
0277,OTHERMLT,4,33,29,16,27
0277,PERSONS18,1115,1077,-38,1100,1085
0277,WHITE18,980,885,-95,942,904
0277,BLACK18,56,116,60,80,104
0277,HISPANIC18,40,41,1,40,41
0277,ASIAN18,17,15,-2,16,15
0277,AMINDIAN18,16,5,-11,12,7
0277,PISLAND18,0,0,0,0,0
0277,OTHER18,5,0,-5,3,1
0277,OTHERMLT18,1,15,14,7,12
0278,PERSONS,1570,1494,-76,1540,1509
0278,WHITE,1203,1036,-167,1136,1069
0278,BLACK,241,273,32,254,267
0278,HISPANIC,89,98,9,93,96
0278,ASIAN,12,22,10,16,20
0278,AMINDIAN,11,5,-6,9,6
0278,PISLAND,3,0,-3,2,1
0278,OTHER,9,6,-3,8,7
0278,OTHERMLT,2,54,52,23,44
0278,PERSONS18,1203,1182,-21,1195,1186
0278,WHITE18,993,877,-116,947,900
0278,BLACK18,134,193,59,158,181
0278,HISPANIC18,48,63,15,54,60
0278,ASIAN18,8,13,5,10,12
0278,AMINDIAN18,10,4,-6,8,5
0278,PISLAND18,1,0,-1,1,0
0278,OTHER18,9,4,-5,7,5
0278,OTHERMLT18,0,28,28,11,22
0279,PERSONS,1768,1669,-99,1728,1689
0279,WHITE,771,609,-162,706,641
0279,BLACK,680,634,-46,662,643
0279,HISPANIC,73,163,90,109,145
0279,ASIAN,174,150,-24,164,155
0279,AMINDIAN,23,27,4,25,26
0279,PISLAND,1,0,-1,1,0
0279,OTHER,5,5,0,5,5
0279,OTHERMLT,41,81,40,57,73
0279,PERSONS18,1240,1245,5,1242,1244
0279,WHITE18,662,546,-116,616,569
0279,BLACK18,410,442,32,423,436
0279,HISPANIC18,42,100,58,65,88
0279,ASIAN18,86,97,11,90,95
0279,AMINDIAN18,19,21,2,20,21
0279,PISLAND18,1,0,-1,1,0
0279,OTHER18,4,1,-3,3,2
0279,OTHERMLT18,16,38,22,25,34
0028,PERSONS,1564,1517,-47,1545,1526
0028,WHITE,467,226,-241,371,274
0028,BLACK,989,1160,171,1057,1126
0028,HISPANIC,44,54,10,48,52
0028,ASIAN,26,18,-8,23,20
0028,AMINDIAN,9,10,1,9,10
0028,PISLAND,0,0,0,0,0
0028,OTHER,9,5,-4,7,6
0028,OTHERMLT,20,44,24,30,39
0028,PERSONS18,994,977,-17,987,980
0028,WHITE18,376,194,-182,303,230
0028,BLACK18,554,719,165,620,686
0028,HISPANIC18,32,33,1,32,33
0028,ASIAN18,16,10,-6,14,11
0028,AMINDIAN18,8,5,-3,7,6
0028,PISLAND18,0,0,0,0,0
0028,OTHER18,2,1,-1,2,1
0028,OTHERMLT18,6,15,9,10,13
0280,PERSONS,1048,1064,16,1054,1061
0280,WHITE,949,819,-130,897,845
0280,BLACK,42,105,63,67,92
0280,HISPANIC,31,64,33,44,57
0280,ASIAN,20,38,18,27,34
0280,AMINDIAN,1,10,9,5,8
0280,PISLAND,2,0,-2,1,0
0280,OTHER,0,2,2,1,2
0280,OTHERMLT,3,26,23,12,21
0280,PERSONS18,861,893,32,874,887
0280,WHITE18,792,711,-81,760,727
0280,BLACK18,30,83,53,51,72
0280,HISPANIC18,20,51,31,32,45
0280,ASIAN18,15,29,14,21,26
0280,AMINDIAN18,1,4,3,2,3
0280,PISLAND18,2,0,-2,1,0
0280,OTHER18,0,2,2,1,2
0280,OTHERMLT18,1,13,12,6,11
0281,PERSONS,1276,1120,-156,1214,1151
0281,WHITE,630,476,-154,568,507
0281,BLACK,276,292,16,282,289
0281,HISPANIC,131,173,42,148,165
0281,ASIAN,169,111,-58,146,123
0281,AMINDIAN,39,12,-27,28,17
0281,PISLAND,1,0,-1,1,0
0281,OTHER,18,1,-17,11,4
0281,OTHERMLT,12,55,43,29,46
0281,PERSONS18,878,806,-72,849,820
0281,WHITE18,536,419,-117,489,442
0281,BLACK18,154,187,33,167,180
0281,HISPANIC18,80,105,25,90,100
0281,ASIAN18,71,62,-9,67,64
0281,AMINDIAN18,23,10,-13,18,13
0281,PISLAND18,1,0,-1,1,0
0281,OTHER18,9,1,-8,6,3
0281,OTHERMLT18,4,22,18,11,18
0282,PERSONS,1238,1190,-48,1219,1200
0282,WHITE,1108,1037,-71,1080,1051
0282,BLACK,60,54,-6,58,55
0282,HISPANIC,35,56,21,43,52
0282,ASIAN,19,10,-9,15,12
0282,AMINDIAN,11,5,-6,9,6
0282,PISLAND,1,1,0,1,1
0282,OTHER,2,3,1,2,3
0282,OTHERMLT,2,24,22,11,20
0282,PERSONS18,907,937,30,919,931
0282,WHITE18,835,837,2,836,837
0282,BLACK18,29,36,7,32,35
0282,HISPANIC18,21,34,13,26,31
0282,ASIAN18,12,9,-3,11,10
0282,AMINDIAN18,7,4,-3,6,5
0282,PISLAND18,1,1,0,1,1
0282,OTHER18,0,3,3,1,2
0282,OTHERMLT18,2,13,11,6,11
0283,PERSONS,1408,1367,-41,1392,1375
0283,WHITE,1270,1075,-195,1192,1114
0283,BLACK,24,83,59,48,71
0283,HISPANIC,80,137,57,103,126
0283,ASIAN,8,23,15,14,20
0283,AMINDIAN,21,9,-12,16,11
0283,PISLAND,0,0,0,0,0
0283,OTHER,1,7,6,3,6
0283,OTHERMLT,4,33,29,16,27
0283,PERSONS18,1152,1107,-45,1134,1116
0283,WHITE18,1060,921,-139,1004,949
0283,BLACK18,17,58,41,33,50
0283,HISPANIC18,52,76,24,62,71
0283,ASIAN18,5,22,17,12,19
0283,AMINDIAN18,14,9,-5,12,10
0283,PISLAND18,0,0,0,0,0
0283,OTHER18,0,4,4,2,3
0283,OTHERMLT18,4,17,13,9,14
0284,PERSONS,1416,1415,-1,1416,1415
0284,WHITE,1274,1154,-120,1226,1178
0284,BLACK,23,84,61,47,72
0284,HISPANIC,67,118,51,87,108
0284,ASIAN,25,19,-6,23,20
0284,AMINDIAN,18,4,-14,12,7
0284,PISLAND,0,1,1,0,1
0284,OTHER,6,0,-6,4,1
0284,OTHERMLT,3,35,32,16,29
0284,PERSONS18,1150,1152,2,1151,1152
0284,WHITE18,1063,995,-68,1036,1009
0284,BLACK18,10,53,43,27,44
0284,HISPANIC18,42,74,32,55,68
0284,ASIAN18,18,15,-3,17,16
0284,AMINDIAN18,13,4,-9,9,6
0284,PISLAND18,0,1,1,0,1
0284,OTHER18,2,0,-2,1,0
0284,OTHERMLT18,2,10,8,5,8
0289,PERSONS,2242,2228,-14,2236,2231
0289,WHITE,1805,1508,-297,1686,1567
0289,BLACK,211,252,41,227,244
0289,HISPANIC,134,351,217,221,308
0289,ASIAN,52,22,-30,40,28
0289,AMINDIAN,29,21,-8,26,23
0289,PISLAND,0,1,1,0,1
0289,OTHER,4,4,0,4,4
0289,OTHERMLT,7,69,62,32,57
0289,PERSONS18,1814,1799,-15,1808,1802
0289,WHITE18,1513,1310,-203,1432,1351
0289,BLACK18,154,217,63,179,204
0289,HISPANIC18,77,205,128,128,179
0289,ASIAN18,35,17,-18,28,21
0289,AMINDIAN18,25,18,-7,22,19
0289,PISLAND18,0,1,1,0,1
0289,OTHER18,3,2,-1,3,2
0289,OTHERMLT18,7,29,22,16,25
0029,PERSONS,1411,1408,-3,1410,1409
0029,WHITE,366,161,-205,284,202
0029,BLACK,913,1040,127,964,1015
0029,HISPANIC,29,37,8,32,35
0029,ASIAN,93,129,36,107,122
0029,AMINDIAN,3,6,3,4,5
0029,PISLAND,0,0,0,0,0
0029,OTHER,4,2,-2,3,2
0029,OTHERMLT,3,33,30,15,27
0029,PERSONS18,941,963,22,950,959
0029,WHITE18,302,146,-156,240,177
0029,BLACK18,575,704,129,627,678
0029,HISPANIC18,17,21,4,19,20
0029,ASIAN18,42,78,36,56,71
0029,AMINDIAN18,3,4,1,3,4
0029,PISLAND18,0,0,0,0,0
0029,OTHER18,1,0,-1,1,0
0029,OTHERMLT18,1,10,9,5,8
0290,PERSONS,1468,1592,124,1518,1567
0290,WHITE,527,346,-181,455,382
0290,BLACK,153,164,11,157,162
0290,HISPANIC,571,924,353,712,853
0290,ASIAN,87,81,-6,85,82
0290,AMINDIAN,108,32,-76,78,47
0290,PISLAND,0,0,0,0,0
0290,OTHER,8,3,-5,6,4
0290,OTHERMLT,14,42,28,25,36
0290,PERSONS18,976,1035,59,1000,1023
0290,WHITE18,435,301,-134,381,328
0290,BLACK18,82,92,10,86,90
0290,HISPANIC18,341,539,198,420,499
0290,ASIAN18,47,52,5,49,51
0290,AMINDIAN18,55,28,-27,44,33
0290,PISLAND18,0,0,0,0,0
0290,OTHER18,7,3,-4,5,4
0290,OTHERMLT18,9,20,11,13,18
0291,PERSONS,1071,1067,-4,1069,1068
0291,WHITE,364,195,-169,296,229
0291,BLACK,44,20,-24,34,25
0291,HISPANIC,511,779,268,618,725
0291,ASIAN,115,51,-64,89,64
0291,AMINDIAN,32,3,-29,20,9
0291,PISLAND,1,0,-1,1,0
0291,OTHER,4,0,-4,2,1
0291,OTHERMLT,0,19,19,8,15
0291,PERSONS18,738,718,-20,730,722
0291,WHITE18,318,169,-149,258,199
0291,BLACK18,28,14,-14,22,17
0291,HISPANIC18,299,489,190,375,451
0291,ASIAN18,67,37,-30,55,43
0291,AMINDIAN18,21,2,-19,13,6
0291,PISLAND18,1,0,-1,1,0
0291,OTHER18,4,0,-4,2,1
0291,OTHERMLT18,0,7,7,3,6
0292,PERSONS,1951,2019,68,1978,2005
0292,WHITE,627,404,-223,538,449
0292,BLACK,58,87,29,70,81
0292,HISPANIC,1010,1358,348,1149,1288
0292,ASIAN,212,117,-95,174,136
0292,AMINDIAN,30,24,-6,28,25
0292,PISLAND,0,0,0,0,0
0292,OTHER,2,1,-1,2,1
0292,OTHERMLT,12,28,16,18,25
0292,PERSONS18,1271,1303,32,1284,1297
0292,WHITE18,505,347,-158,442,379
0292,BLACK18,30,50,20,38,46
0292,HISPANIC18,601,812,211,685,770
0292,ASIAN18,110,71,-39,94,79
0292,AMINDIAN18,18,16,-2,17,16
0292,PISLAND18,0,0,0,0,0
0292,OTHER18,1,0,-1,1,0
0292,OTHERMLT18,6,7,1,6,7
0293,PERSONS,1240,1267,27,1251,1262
0293,WHITE,445,225,-220,357,269
0293,BLACK,65,58,-7,62,59
0293,HISPANIC,555,897,342,692,829
0293,ASIAN,77,50,-27,66,55
0293,AMINDIAN,43,23,-20,35,27
0293,PISLAND,0,0,0,0,0
0293,OTHER,31,0,-31,19,6
0293,OTHERMLT,24,14,-10,20,16
0293,PERSONS18,791,810,19,799,806
0293,WHITE18,333,182,-151,273,212
0293,BLACK18,32,44,12,37,42
0293,HISPANIC18,317,524,207,400,483
0293,ASIAN18,47,38,-9,43,40
0293,AMINDIAN18,28,17,-11,24,19
0293,PISLAND18,0,0,0,0,0
0293,OTHER18,16,0,-16,10,3
0293,OTHERMLT18,18,5,-13,13,8
0294,PERSONS,1299,1493,194,1377,1454
0294,WHITE,518,275,-243,421,324
0294,BLACK,57,94,37,72,87
0294,HISPANIC,545,994,449,725,904
0294,ASIAN,104,61,-43,87,70
0294,AMINDIAN,63,27,-36,49,34
0294,PISLAND,0,0,0,0,0
0294,OTHER,8,0,-8,5,2
0294,OTHERMLT,4,42,38,19,34
0294,PERSONS18,862,997,135,916,970
0294,WHITE18,417,246,-171,349,280
0294,BLACK18,31,66,35,45,59
0294,HISPANIC18,313,602,289,429,544
0294,ASIAN18,61,42,-19,53,46
0294,AMINDIAN18,30,23,-7,27,24
0294,PISLAND18,0,0,0,0,0
0294,OTHER18,6,0,-6,4,1
0294,OTHERMLT18,4,18,14,10,15
0299,PERSONS,2570,2203,-367,2423,2276
0299,WHITE,45,45,0,45,45
0299,BLACK,2424,2019,-405,2262,2100
0299,HISPANIC,51,55,4,53,54
0299,ASIAN,21,28,7,24,27
0299,AMINDIAN,3,5,2,4,5
0299,PISLAND,0,0,0,0,0
0299,OTHER,1,0,-1,1,0
0299,OTHERMLT,25,51,26,35,46
0299,PERSONS18,1477,1391,-86,1443,1408
0299,WHITE18,44,34,-10,40,36
0299,BLACK18,1380,1276,-104,1338,1297
0299,HISPANIC18,25,31,6,27,30
0299,ASIAN18,12,17,5,14,16
0299,AMINDIAN18,2,5,3,3,4
0299,PISLAND18,0,0,0,0,0
0299,OTHER18,1,0,-1,1,0
0299,OTHERMLT18,13,28,15,19,25
0003,PERSONS,1811,1761,-50,1791,1771
0003,WHITE,115,55,-60,91,67
0003,BLACK,1639,1616,-23,1630,1621
0003,HISPANIC,29,41,12,34,39
0003,ASIAN,1,1,0,1,1
0003,AMINDIAN,9,3,-6,7,4
0003,PISLAND,0,1,1,0,1
0003,OTHER,0,0,0,0,0
0003,OTHERMLT,18,44,26,28,39
0003,PERSONS18,1237,1248,11,1241,1246
0003,WHITE18,105,51,-54,83,62
0003,BLACK18,1094,1153,59,1118,1141
0003,HISPANIC18,17,23,6,19,22
0003,ASIAN18,1,1,0,1,1
0003,AMINDIAN18,6,3,-3,5,4
0003,PISLAND18,0,1,1,0,1
0003,OTHER18,0,0,0,0,0
0003,OTHERMLT18,14,16,2,15,16
0030,PERSONS,1857,1941,84,1891,1924
0030,WHITE,626,265,-361,482,337
0030,BLACK,1026,1367,341,1162,1299
0030,HISPANIC,48,46,-2,47,46
0030,ASIAN,123,201,78,154,185
0030,AMINDIAN,6,3,-3,5,4
0030,PISLAND,0,0,0,0,0
0030,OTHER,7,0,-7,4,1
0030,OTHERMLT,21,59,38,36,51
0030,PERSONS18,1263,1298,35,1277,1291
0030,WHITE18,521,234,-287,406,291
0030,BLACK18,650,890,240,746,842
0030,HISPANIC18,26,31,5,28,30
0030,ASIAN18,53,111,58,76,99
0030,AMINDIAN18,4,3,-1,4,3
0030,PISLAND18,0,0,0,0,0
0030,OTHER18,0,0,0,0,0
0030,OTHERMLT18,9,29,20,17,25
0300,PERSONS,2055,1784,-271,1947,1838
0300,WHITE,80,73,-7,77,74
0300,BLACK,1646,1333,-313,1521,1396
0300,HISPANIC,71,66,-5,69,67
0300,ASIAN,215,265,50,235,255
0300,AMINDIAN,11,9,-2,10,9
0300,PISLAND,4,0,-4,2,1
0300,OTHER,0,0,0,0,0
0300,OTHERMLT,28,38,10,32,36
0300,PERSONS18,1037,1090,53,1058,1079
0300,WHITE18,62,62,0,62,62
0300,BLACK18,821,822,1,821,822
0300,HISPANIC18,43,40,-3,42,41
0300,ASIAN18,87,143,56,109,132
0300,AMINDIAN18,9,5,-4,7,6
0300,PISLAND18,4,0,-4,2,1
0300,OTHER18,0,0,0,0,0
0300,OTHERMLT18,11,18,7,14,17
0301,PERSONS,2084,1705,-379,1932,1781
0301,WHITE,65,27,-38,50,35
0301,BLACK,1870,1533,-337,1735,1600
0301,HISPANIC,91,51,-40,75,59
0301,ASIAN,44,66,22,53,62
0301,AMINDIAN,4,2,-2,3,2
0301,PISLAND,0,0,0,0,0
0301,OTHER,0,4,4,2,3
0301,OTHERMLT,10,22,12,15,20
0301,PERSONS18,1036,951,-85,1002,968
0301,WHITE18,58,24,-34,44,31
0301,BLACK18,906,854,-52,885,864
0301,HISPANIC18,47,27,-20,39,31
0301,ASIAN18,18,30,12,23,28
0301,AMINDIAN18,2,1,-1,2,1
0301,PISLAND18,0,0,0,0,0
0301,OTHER18,0,4,4,2,3
0301,OTHERMLT18,5,11,6,7,10
0302,PERSONS,2618,2253,-365,2472,2326
0302,WHITE,117,67,-50,97,77
0302,BLACK,2313,1974,-339,2177,2042
0302,HISPANIC,83,85,2,84,85
0302,ASIAN,37,59,22,46,55
0302,AMINDIAN,15,5,-10,11,7
0302,PISLAND,0,0,0,0,0
0302,OTHER,7,4,-3,6,5
0302,OTHERMLT,46,59,13,51,56
0302,PERSONS18,1355,1287,-68,1328,1301
0302,WHITE18,98,56,-42,81,64
0302,BLACK18,1160,1136,-24,1150,1141
0302,HISPANIC18,48,39,-9,44,41
0302,ASIAN18,17,27,10,21,25
0302,AMINDIAN18,10,3,-7,7,4
0302,PISLAND18,0,0,0,0,0
0302,OTHER18,2,3,1,2,3
0302,OTHERMLT18,20,23,3,21,22
0303,PERSONS,2064,1791,-273,1955,1846
0303,WHITE,145,107,-38,130,115
0303,BLACK,1811,1538,-273,1702,1593
0303,HISPANIC,42,68,26,52,63
0303,ASIAN,40,16,-24,30,21
0303,AMINDIAN,0,8,8,3,6
0303,PISLAND,0,2,2,1,2
0303,OTHER,5,1,-4,3,2
0303,OTHERMLT,21,51,30,33,45
0303,PERSONS18,1110,1066,-44,1092,1075
0303,WHITE18,123,94,-29,111,100
0303,BLACK18,937,902,-35,923,909
0303,HISPANIC18,18,30,12,23,28
0303,ASIAN18,20,12,-8,17,14
0303,AMINDIAN18,0,4,4,2,3
0303,PISLAND18,0,2,2,1,2
0303,OTHER18,2,1,-1,2,1
0303,OTHERMLT18,9,21,12,14,19
0304,PERSONS,1719,1509,-210,1635,1551
0304,WHITE,214,138,-76,184,153
0304,BLACK,1349,1165,-184,1275,1202
0304,HISPANIC,69,77,8,72,75
0304,ASIAN,53,58,5,55,57
0304,AMINDIAN,15,5,-10,11,7
0304,PISLAND,1,0,-1,1,0
0304,OTHER,1,9,8,4,7
0304,OTHERMLT,17,57,40,33,49
0304,PERSONS18,989,945,-44,971,954
0304,WHITE18,189,109,-80,157,125
0304,BLACK18,725,725,0,725,725
0304,HISPANIC18,34,50,16,40,47
0304,ASIAN18,21,33,12,26,31
0304,AMINDIAN18,12,2,-10,8,4
0304,PISLAND18,0,0,0,0,0
0304,OTHER18,1,1,0,1,1
0304,OTHERMLT18,7,25,18,14,21
0305,PERSONS,1784,1563,-221,1696,1607
0305,WHITE,270,271,1,270,271
0305,BLACK,1360,1120,-240,1264,1168
0305,HISPANIC,50,58,8,53,56
0305,ASIAN,62,53,-9,58,55
0305,AMINDIAN,15,9,-6,13,10
0305,PISLAND,0,0,0,0,0
0305,OTHER,2,0,-2,1,0
0305,OTHERMLT,25,52,27,36,47
0305,PERSONS18,1031,1009,-22,1022,1013
0305,WHITE18,227,227,0,227,227
0305,BLACK18,722,698,-24,712,703
0305,HISPANIC18,28,31,3,29,30
0305,ASIAN18,32,31,-1,32,31
0305,AMINDIAN18,11,6,-5,9,7
0305,PISLAND18,0,0,0,0,0
0305,OTHER18,0,0,0,0,0
0305,OTHERMLT18,11,16,5,13,15
0306,PERSONS,2256,1866,-390,2100,1944
0306,WHITE,120,91,-29,108,97
0306,BLACK,1765,1387,-378,1614,1463
0306,HISPANIC,98,91,-7,95,92
0306,ASIAN,236,240,4,238,239
0306,AMINDIAN,13,5,-8,10,7
0306,PISLAND,0,0,0,0,0
0306,OTHER,3,0,-3,2,1
0306,OTHERMLT,21,52,31,33,46
0306,PERSONS18,1124,1025,-99,1084,1045
0306,WHITE18,110,75,-35,96,82
0306,BLACK18,837,746,-91,801,764
0306,HISPANIC18,53,52,-1,53,52
0306,ASIAN18,104,129,25,114,124
0306,AMINDIAN18,9,3,-6,7,4
0306,PISLAND18,0,0,0,0,0
0306,OTHER18,3,0,-3,2,1
0306,OTHERMLT18,8,20,12,13,18
0307,PERSONS,1749,1429,-320,1621,1493
0307,WHITE,476,203,-273,367,258
0307,BLACK,998,920,-78,967,936
0307,HISPANIC,102,161,59,126,149
0307,ASIAN,127,86,-41,111,94
0307,AMINDIAN,31,4,-27,20,9
0307,PISLAND,1,0,-1,1,0
0307,OTHER,2,4,2,3,4
0307,OTHERMLT,12,51,39,28,43
0307,PERSONS18,1244,1013,-231,1152,1059
0307,WHITE18,443,191,-252,342,241
0307,BLACK18,652,631,-21,644,635
0307,HISPANIC18,59,108,49,79,98
0307,ASIAN18,63,51,-12,58,53
0307,AMINDIAN18,18,4,-14,12,7
0307,PISLAND18,1,0,-1,1,0
0307,OTHER18,2,1,-1,2,1
0307,OTHERMLT18,6,27,21,14,23
0032,PERSONS,1889,1872,-17,1882,1875
0032,WHITE,391,195,-196,313,234
0032,BLACK,1425,1544,119,1473,1520
0032,HISPANIC,39,61,22,48,57
0032,ASIAN,14,18,4,16,17
0032,AMINDIAN,9,7,-2,8,7
0032,PISLAND,1,0,-1,1,0
0032,OTHER,2,2,0,2,2
0032,OTHERMLT,8,45,37,23,38
0032,PERSONS18,1237,1295,58,1260,1283
0032,WHITE18,335,174,-161,271,206
0032,BLACK18,863,1045,182,936,1009
0032,HISPANIC18,16,31,15,22,28
0032,ASIAN18,11,17,6,13,16
0032,AMINDIAN18,6,4,-2,5,4
0032,PISLAND18,0,0,0,0,0
0032,OTHER18,1,2,1,1,2
0032,OTHERMLT18,5,22,17,12,19
0033,PERSONS,2010,2025,15,2016,2022
0033,WHITE,488,210,-278,377,266
0033,BLACK,1382,1577,195,1460,1538
0033,HISPANIC,69,116,47,88,107
0033,ASIAN,45,48,3,46,47
0033,AMINDIAN,3,1,-2,2,1
0033,PISLAND,0,0,0,0,0
0033,OTHER,9,5,-4,7,6
0033,OTHERMLT,14,68,54,36,57
0033,PERSONS18,1403,1387,-16,1397,1390
0033,WHITE18,424,189,-235,330,236
0033,BLACK18,902,1063,161,966,1031
0033,HISPANIC18,42,64,22,51,60
0033,ASIAN18,19,33,14,25,30
0033,AMINDIAN18,2,1,-1,2,1
0033,PISLAND18,0,0,0,0,0
0033,OTHER18,4,4,0,4,4
0033,OTHERMLT18,10,33,23,19,28
0034,PERSONS,1240,1236,-4,1238,1237
0034,WHITE,484,207,-277,373,262
0034,BLACK,620,867,247,719,818
0034,HISPANIC,52,59,7,55,58
0034,ASIAN,54,71,17,61,68
0034,AMINDIAN,24,4,-20,16,8
0034,PISLAND,0,1,1,0,1
0034,OTHER,3,0,-3,2,1
0034,OTHERMLT,3,27,24,13,22
0034,PERSONS18,905,879,-26,895,884
0034,WHITE18,421,182,-239,325,230
0034,BLACK18,417,602,185,491,565
0034,HISPANIC18,29,37,8,32,35
0034,ASIAN18,24,45,21,32,41
0034,AMINDIAN18,10,3,-7,7,4
0034,PISLAND18,0,1,1,0,1
0034,OTHER18,2,0,-2,1,0
0034,OTHERMLT18,2,9,7,5,8
0035,PERSONS,1612,1411,-201,1532,1451
0035,WHITE,290,147,-143,233,176
0035,BLACK,1226,1162,-64,1200,1175
0035,HISPANIC,28,32,4,30,31
0035,ASIAN,47,29,-18,40,33
0035,AMINDIAN,12,5,-7,9,6
0035,PISLAND,0,0,0,0,0
0035,OTHER,5,5,0,5,5
0035,OTHERMLT,4,31,27,15,26
0035,PERSONS18,1118,1031,-87,1083,1048
0035,WHITE18,252,136,-116,206,159
0035,BLACK18,805,832,27,816,827
0035,HISPANIC18,18,18,0,18,18
0035,ASIAN18,27,22,-5,25,23
0035,AMINDIAN18,10,3,-7,7,4
0035,PISLAND18,0,0,0,0,0
0035,OTHER18,3,3,0,3,3
0035,OTHERMLT18,3,17,14,9,14
0036,PERSONS,2745,2632,-113,2700,2655
0036,WHITE,1097,559,-538,882,667
0036,BLACK,1417,1833,416,1583,1750
0036,HISPANIC,103,112,9,107,110
0036,ASIAN,72,48,-24,62,53
0036,AMINDIAN,15,7,-8,12,9
0036,PISLAND,0,1,1,0,1
0036,OTHER,8,5,-3,7,6
0036,OTHERMLT,33,67,34,47,60
0036,PERSONS18,1943,1912,-31,1931,1918
0036,WHITE18,908,496,-412,743,578
0036,BLACK18,900,1283,383,1053,1206
0036,HISPANIC18,59,68,9,63,66
0036,ASIAN18,40,30,-10,36,32
0036,AMINDIAN18,15,4,-11,11,6
0036,PISLAND18,0,1,1,0,1
0036,OTHER18,3,4,1,3,4
0036,OTHERMLT18,18,26,8,21,24
0037,PERSONS,3118,3233,115,3164,3210
0037,WHITE,2554,2094,-460,2370,2186
0037,BLACK,402,813,411,566,731
0037,HISPANIC,102,156,54,124,145
0037,ASIAN,19,28,9,23,26
0037,AMINDIAN,19,11,-8,16,13
0037,PISLAND,0,3,3,1,2
0037,OTHER,7,6,-1,7,6
0037,OTHERMLT,15,122,107,58,101
0037,PERSONS18,2440,2382,-58,2417,2394
0037,WHITE18,2068,1637,-431,1896,1723
0037,BLACK18,271,584,313,396,521
0037,HISPANIC18,62,86,24,72,81
0037,ASIAN18,11,22,11,15,20
0037,AMINDIAN18,14,9,-5,12,10
0037,PISLAND18,0,2,2,1,2
0037,OTHER18,4,2,-2,3,2
0037,OTHERMLT18,10,40,30,22,34
0038,PERSONS,1741,1735,-6,1739,1736
0038,WHITE,1603,1567,-36,1589,1574
0038,BLACK,34,37,3,35,36
0038,HISPANIC,51,83,32,64,77
0038,ASIAN,34,25,-9,30,27
0038,AMINDIAN,6,2,-4,4,3
0038,PISLAND,2,0,-2,1,0
0038,OTHER,6,1,-5,4,2
0038,OTHERMLT,5,20,15,11,17
0038,PERSONS18,1423,1431,8,1426,1429
0038,WHITE18,1319,1301,-18,1312,1305
0038,BLACK18,27,29,2,28,29
0038,HISPANIC18,33,61,28,44,55
0038,ASIAN18,29,24,-5,27,25
0038,AMINDIAN18,6,2,-4,4,3
0038,PISLAND18,2,0,-2,1,0
0038,OTHER18,3,1,-2,2,1
0038,OTHERMLT18,4,13,9,8,11
0039,PERSONS,1933,2784,851,2273,2614
0039,WHITE,1731,2454,723,2020,2309
0039,BLACK,77,100,23,86,95
0039,HISPANIC,44,97,53,65,86
0039,ASIAN,63,59,-4,61,60
0039,AMINDIAN,8,8,0,8,8
0039,PISLAND,1,1,0,1,1
0039,OTHER,3,22,19,11,18
0039,OTHERMLT,6,43,37,21,36
0039,PERSONS18,1913,2763,850,2253,2593
0039,WHITE18,1718,2437,719,2006,2293
0039,BLACK18,75,99,24,85,94
0039,HISPANIC18,42,96,54,64,85
0039,ASIAN18,60,57,-3,59,58
0039,AMINDIAN18,8,8,0,8,8
0039,PISLAND18,1,1,0,1,1
0039,OTHER18,3,22,19,11,18
0039,OTHERMLT18,6,43,37,21,36
0004,PERSONS,1124,1047,-77,1093,1062
0004,WHITE,145,64,-81,113,80
0004,BLACK,926,928,2,927,928
0004,HISPANIC,20,26,6,22,25
0004,ASIAN,11,18,7,14,17
0004,AMINDIAN,2,0,-2,1,0
0004,PISLAND,0,0,0,0,0
0004,OTHER,1,0,-1,1,0
0004,OTHERMLT,19,11,-8,16,13
0004,PERSONS18,750,732,-18,743,736
0004,WHITE18,131,61,-70,103,75
0004,BLACK18,585,639,54,607,628
0004,HISPANIC18,14,18,4,16,17
0004,ASIAN18,6,8,2,7,8
0004,AMINDIAN18,2,0,-2,1,0
0004,PISLAND18,0,0,0,0,0
0004,OTHER18,1,0,-1,1,0
0004,OTHERMLT18,11,6,-5,9,7
0040,PERSONS,2468,2472,4,2470,2471
0040,WHITE,2143,2164,21,2151,2160
0040,BLACK,56,55,-1,56,55
0040,HISPANIC,81,85,4,83,84
0040,ASIAN,146,114,-32,133,120
0040,AMINDIAN,31,12,-19,23,16
0040,PISLAND,1,1,0,1,1
0040,OTHER,5,6,1,5,6
0040,OTHERMLT,5,35,30,17,29
0040,PERSONS18,2219,2335,116,2265,2312
0040,WHITE18,1947,2070,123,1996,2045
0040,BLACK18,49,48,-1,49,48
0040,HISPANIC18,56,66,10,60,64
0040,ASIAN18,135,111,-24,125,116
0040,AMINDIAN18,23,10,-13,18,13
0040,PISLAND18,1,1,0,1,1
0040,OTHER18,4,3,-1,4,3
0040,OTHERMLT18,4,26,22,13,22
0041,PERSONS,1946,1960,14,1952,1957
0041,WHITE,1282,1270,-12,1277,1272
0041,BLACK,395,376,-19,387,380
0041,HISPANIC,198,202,4,200,201
0041,ASIAN,33,21,-12,28,23
0041,AMINDIAN,17,14,-3,16,15
0041,PISLAND,2,0,-2,1,0
0041,OTHER,6,0,-6,4,1
0041,OTHERMLT,13,77,64,39,64
0041,PERSONS18,1625,1669,44,1643,1660
0041,WHITE18,1130,1140,10,1134,1138
0041,BLACK18,305,321,16,311,318
0041,HISPANIC18,134,144,10,138,142
0041,ASIAN18,26,19,-7,23,20
0041,AMINDIAN18,12,10,-2,11,10
0041,PISLAND18,2,0,-2,1,0
0041,OTHER18,6,0,-6,4,1
0041,OTHERMLT18,10,35,25,20,30
0042,PERSONS,2257,2251,-6,2255,2252
0042,WHITE,2098,2084,-14,2092,2087
0042,BLACK,50,48,-2,49,48
0042,HISPANIC,39,38,-1,39,38
0042,ASIAN,55,44,-11,51,46
0042,AMINDIAN,5,1,-4,3,2
0042,PISLAND,0,0,0,0,0
0042,OTHER,9,1,-8,6,3
0042,OTHERMLT,1,35,34,15,28
0042,PERSONS18,1953,2013,60,1977,2001
0042,WHITE18,1834,1888,54,1856,1877
0042,BLACK18,38,40,2,39,40
0042,HISPANIC18,24,28,4,26,27
0042,ASIAN18,45,37,-8,42,39
0042,AMINDIAN18,5,1,-4,3,2
0042,PISLAND18,0,0,0,0,0
0042,OTHER18,6,1,-5,4,2
0042,OTHERMLT18,1,18,17,8,15
0043,PERSONS,1676,1780,104,1718,1759
0043,WHITE,1491,1604,113,1536,1581
0043,BLACK,54,38,-16,48,41
0043,HISPANIC,30,45,15,36,42
0043,ASIAN,74,46,-28,63,52
0043,AMINDIAN,9,1,-8,6,3
0043,PISLAND,0,0,0,0,0
0043,OTHER,16,15,-1,16,15
0043,OTHERMLT,2,31,29,14,25
0043,PERSONS18,1494,1580,86,1528,1563
0043,WHITE18,1336,1448,112,1381,1426
0043,BLACK18,42,28,-14,36,31
0043,HISPANIC18,29,38,9,33,36
0043,ASIAN18,66,39,-27,55,44
0043,AMINDIAN18,9,1,-8,6,3
0043,PISLAND18,0,0,0,0,0
0043,OTHER18,10,3,-7,7,4
0043,OTHERMLT18,2,23,21,10,19
0044,PERSONS,2840,2795,-45,2822,2804
0044,WHITE,2553,2531,-22,2544,2535
0044,BLACK,70,52,-18,63,56
0044,HISPANIC,62,86,24,72,81
0044,ASIAN,120,68,-52,99,78
0044,AMINDIAN,13,5,-8,10,7
0044,PISLAND,1,1,0,1,1
0044,OTHER,16,3,-13,11,6
0044,OTHERMLT,5,49,44,23,40
0044,PERSONS18,2662,2678,16,2668,2675
0044,WHITE18,2413,2438,25,2423,2433
0044,BLACK18,55,49,-6,53,50
0044,HISPANIC18,56,81,25,66,76
0044,ASIAN18,108,61,-47,89,70
0044,AMINDIAN18,12,5,-7,9,6
0044,PISLAND18,1,1,0,1,1
0044,OTHER18,13,1,-12,8,3
0044,OTHERMLT18,4,42,38,19,34
0045,PERSONS,1578,1455,-123,1529,1480
0045,WHITE,1430,1314,-116,1384,1337
0045,BLACK,40,46,6,42,45
0045,HISPANIC,38,35,-3,37,36
0045,ASIAN,59,39,-20,51,43
0045,AMINDIAN,4,2,-2,3,2
0045,PISLAND,0,1,1,0,1
0045,OTHER,2,0,-2,1,0
0045,OTHERMLT,5,18,13,10,15
0045,PERSONS18,1527,1424,-103,1486,1445
0045,WHITE18,1389,1291,-98,1350,1311
0045,BLACK18,34,46,12,39,44
0045,HISPANIC18,37,33,-4,35,34
0045,ASIAN18,56,36,-20,48,40
0045,AMINDIAN18,4,1,-3,3,2
0045,PISLAND18,0,1,1,0,1
0045,OTHER18,2,0,-2,1,0
0045,OTHERMLT18,5,16,11,9,14
0046,PERSONS,1730,1746,16,1736,1743
0046,WHITE,1409,1434,25,1419,1429
0046,BLACK,68,73,5,70,72
0046,HISPANIC,73,53,-20,65,57
0046,ASIAN,154,139,-15,148,142
0046,AMINDIAN,9,4,-5,7,5
0046,PISLAND,4,3,-1,4,3
0046,OTHER,4,1,-3,3,2
0046,OTHERMLT,9,39,30,21,33
0046,PERSONS18,1646,1682,36,1660,1675
0046,WHITE18,1354,1400,46,1372,1391
0046,BLACK18,61,65,4,63,64
0046,HISPANIC18,64,49,-15,58,52
0046,ASIAN18,145,133,-12,140,135
0046,AMINDIAN18,7,4,-3,6,5
0046,PISLAND18,4,3,-1,4,3
0046,OTHER18,2,1,-1,2,1
0046,OTHERMLT18,9,27,18,16,23
0047,PERSONS,1320,1507,187,1395,1470
0047,WHITE,1151,1285,134,1205,1258
0047,BLACK,42,62,20,50,58
0047,HISPANIC,45,55,10,49,53
0047,ASIAN,53,55,2,54,55
0047,AMINDIAN,11,1,-10,7,3
0047,PISLAND,2,0,-2,1,0
0047,OTHER,10,3,-7,7,4
0047,OTHERMLT,6,46,40,22,38
0047,PERSONS18,1247,1450,203,1328,1409
0047,WHITE18,1093,1253,160,1157,1221
0047,BLACK18,36,57,21,44,53
0047,HISPANIC18,41,49,8,44,47
0047,ASIAN18,51,54,3,52,53
0047,AMINDIAN18,10,1,-9,6,3
0047,PISLAND18,1,0,-1,1,0
0047,OTHER18,10,3,-7,7,4
0047,OTHERMLT18,5,33,28,16,27
0048,PERSONS,1619,1988,369,1767,1914
0048,WHITE,1085,1498,413,1250,1415
0048,BLACK,300,225,-75,270,240
0048,HISPANIC,168,139,-29,156,145
0048,ASIAN,32,36,4,34,35
0048,AMINDIAN,18,10,-8,15,12
0048,PISLAND,0,0,0,0,0
0048,OTHER,9,12,3,10,11
0048,OTHERMLT,7,68,61,31,56
0048,PERSONS18,1348,1826,478,1539,1730
0048,WHITE18,982,1429,447,1161,1340
0048,BLACK18,199,185,-14,193,188
0048,HISPANIC18,108,110,2,109,110
0048,ASIAN18,29,36,7,32,35
0048,AMINDIAN18,16,8,-8,13,10
0048,PISLAND18,0,0,0,0,0
0048,OTHER18,8,9,1,8,9
0048,OTHERMLT18,6,49,43,23,40
0049,PERSONS,1699,1657,-42,1682,1665
0049,WHITE,1420,1348,-72,1391,1362
0049,BLACK,108,94,-14,102,97
0049,HISPANIC,74,74,0,74,74
0049,ASIAN,63,95,32,76,89
0049,AMINDIAN,17,9,-8,14,11
0049,PISLAND,3,1,-2,2,1
0049,OTHER,7,6,-1,7,6
0049,OTHERMLT,7,30,23,16,25
0049,PERSONS18,1606,1599,-7,1603,1600
0049,WHITE18,1362,1312,-50,1342,1322
0049,BLACK18,87,88,1,87,88
0049,HISPANIC18,64,70,6,66,69
0049,ASIAN18,62,90,28,73,84
0049,AMINDIAN18,15,7,-8,12,9
0049,PISLAND18,3,1,-2,2,1
0049,OTHER18,6,5,-1,6,5
0049,OTHERMLT18,7,26,19,15,22
0005,PERSONS,1801,1657,-144,1743,1686
0005,WHITE,158,73,-85,124,90
0005,BLACK,1565,1476,-89,1529,1494
0005,HISPANIC,40,64,24,50,59
0005,ASIAN,4,1,-3,3,2
0005,AMINDIAN,5,8,3,6,7
0005,PISLAND,0,6,6,2,5
0005,OTHER,3,0,-3,2,1
0005,OTHERMLT,26,29,3,27,28
0005,PERSONS18,1075,1063,-12,1070,1065
0005,WHITE18,135,67,-68,108,81
0005,BLACK18,896,945,49,916,935
0005,HISPANIC18,20,31,11,24,29
0005,ASIAN18,4,0,-4,2,1
0005,AMINDIAN18,4,4,0,4,4
0005,PISLAND18,0,4,4,2,3
0005,OTHER18,3,0,-3,2,1
0005,OTHERMLT18,13,12,-1,13,12
0050,PERSONS,1402,1616,214,1488,1573
0050,WHITE,1240,1335,95,1278,1316
0050,BLACK,89,118,29,101,112
0050,HISPANIC,27,58,31,39,52
0050,ASIAN,24,74,50,44,64
0050,AMINDIAN,8,2,-6,6,3
0050,PISLAND,2,0,-2,1,0
0050,OTHER,5,2,-3,4,3
0050,OTHERMLT,7,27,20,15,23
0050,PERSONS18,1338,1556,218,1425,1512
0050,WHITE18,1181,1293,112,1226,1271
0050,BLACK18,87,117,30,99,111
0050,HISPANIC18,26,51,25,36,46
0050,ASIAN18,22,73,51,42,63
0050,AMINDIAN18,8,1,-7,5,2
0050,PISLAND18,2,0,-2,1,0
0050,OTHER18,5,2,-3,4,3
0050,OTHERMLT18,7,19,12,12,17
0051,PERSONS,2480,2522,42,2497,2514
0051,WHITE,1839,1950,111,1883,1928
0051,BLACK,400,321,-79,368,337
0051,HISPANIC,117,116,-1,117,116
0051,ASIAN,54,64,10,58,62
0051,AMINDIAN,20,8,-12,15,10
0051,PISLAND,4,5,1,4,5
0051,OTHER,22,6,-16,16,9
0051,OTHERMLT,24,52,28,35,46
0051,PERSONS18,2321,2406,85,2355,2389
0051,WHITE18,1758,1882,124,1808,1857
0051,BLACK18,359,306,-53,338,317
0051,HISPANIC18,97,101,4,99,100
0051,ASIAN18,49,57,8,52,55
0051,AMINDIAN18,18,8,-10,14,10
0051,PISLAND18,4,5,1,4,5
0051,OTHER18,17,6,-11,13,8
0051,OTHERMLT18,19,41,22,28,37
0052,PERSONS,2254,2488,234,2348,2441
0052,WHITE,1862,2024,162,1927,1992
0052,BLACK,188,201,13,193,198
0052,HISPANIC,67,105,38,82,97
0052,ASIAN,91,105,14,97,102
0052,AMINDIAN,24,12,-12,19,14
0052,PISLAND,2,1,-1,2,1
0052,OTHER,13,0,-13,8,3
0052,OTHERMLT,7,40,33,20,33
0052,PERSONS18,2195,2428,233,2288,2381
0052,WHITE18,1824,1984,160,1888,1952
0052,BLACK18,180,195,15,186,192
0052,HISPANIC18,62,97,35,76,90
0052,ASIAN18,86,100,14,92,97
0052,AMINDIAN18,24,12,-12,19,14
0052,PISLAND18,2,1,-1,2,1
0052,OTHER18,10,0,-10,6,2
0052,OTHERMLT18,7,39,32,20,33
0053,PERSONS,1739,2157,418,1906,2073
0053,WHITE,1387,1693,306,1509,1632
0053,BLACK,191,222,31,203,216
0053,HISPANIC,95,112,17,102,109
0053,ASIAN,20,54,34,34,47
0053,AMINDIAN,33,14,-19,25,18
0053,PISLAND,1,0,-1,1,0
0053,OTHER,5,8,3,6,7
0053,OTHERMLT,7,54,47,26,45
0053,PERSONS18,1587,2049,462,1772,1957
0053,WHITE18,1309,1634,325,1439,1569
0053,BLACK18,151,211,60,175,199
0053,HISPANIC18,72,96,24,82,91
0053,ASIAN18,20,52,32,33,46
0053,AMINDIAN18,25,13,-12,20,15
0053,PISLAND18,1,0,-1,1,0
0053,OTHER18,5,5,0,5,5
0053,OTHERMLT18,4,38,34,18,31
0054,PERSONS,3793,3794,1,3793,3794
0054,WHITE,3085,3044,-41,3069,3052
0054,BLACK,364,323,-41,348,331
0054,HISPANIC,158,179,21,166,175
0054,ASIAN,96,147,51,116,137
0054,AMINDIAN,43,26,-17,36,29
0054,PISLAND,1,5,4,3,4
0054,OTHER,28,2,-26,18,7
0054,OTHERMLT,18,68,50,38,58
0054,PERSONS18,3609,3637,28,3620,3631
0054,WHITE18,2961,2952,-9,2957,2954
0054,BLACK18,338,303,-35,324,310
0054,HISPANIC18,135,157,22,144,153
0054,ASIAN18,94,136,42,111,128
0054,AMINDIAN18,39,24,-15,33,27
0054,PISLAND18,1,5,4,3,4
0054,OTHER18,25,2,-23,16,7
0054,OTHERMLT18,16,58,42,33,50
0055,PERSONS,1502,1829,327,1633,1764
0055,WHITE,1254,1521,267,1361,1468
0055,BLACK,141,128,-13,136,131
0055,HISPANIC,54,74,20,62,70
0055,ASIAN,34,68,34,48,61
0055,AMINDIAN,9,6,-3,8,7
0055,PISLAND,4,0,-4,2,1
0055,OTHER,3,1,-2,2,1
0055,OTHERMLT,3,31,28,14,25
0055,PERSONS18,1462,1777,315,1588,1714
0055,WHITE18,1238,1496,258,1341,1444
0055,BLACK18,136,114,-22,127,118
0055,HISPANIC18,42,70,28,53,64
0055,ASIAN18,32,65,33,45,58
0055,AMINDIAN18,7,5,-2,6,5
0055,PISLAND18,4,0,-4,2,1
0055,OTHER18,1,1,0,1,1
0055,OTHERMLT18,2,26,24,12,21
0056,PERSONS,2388,2477,89,2424,2459
0056,WHITE,2067,2065,-2,2066,2065
0056,BLACK,137,141,4,139,140
0056,HISPANIC,49,75,26,59,70
0056,ASIAN,106,163,57,129,152
0056,AMINDIAN,8,4,-4,6,5
0056,PISLAND,2,2,0,2,2
0056,OTHER,8,1,-7,5,2
0056,OTHERMLT,11,26,15,17,23
0056,PERSONS18,2354,2425,71,2382,2411
0056,WHITE18,2047,2039,-8,2044,2041
0056,BLACK18,133,134,1,133,134
0056,HISPANIC18,48,68,20,56,64
0056,ASIAN18,99,155,56,121,144
0056,AMINDIAN18,8,4,-4,6,5
0056,PISLAND18,2,2,0,2,2
0056,OTHER18,8,1,-7,5,2
0056,OTHERMLT18,9,22,13,14,19
0057,PERSONS,1792,1704,-88,1757,1722
0057,WHITE,1284,1271,-13,1279,1274
0057,BLACK,86,61,-25,76,66
0057,HISPANIC,348,297,-51,328,307
0057,ASIAN,27,22,-5,25,23
0057,AMINDIAN,29,19,-10,25,21
0057,PISLAND,0,0,0,0,0
0057,OTHER,8,1,-7,5,2
0057,OTHERMLT,10,33,23,19,28
0057,PERSONS18,1358,1459,101,1398,1439
0057,WHITE18,1048,1152,104,1090,1131
0057,BLACK18,41,48,7,44,47
0057,HISPANIC18,216,209,-7,213,210
0057,ASIAN18,16,17,1,16,17
0057,AMINDIAN18,23,14,-9,19,16
0057,PISLAND18,0,0,0,0,0
0057,OTHER18,8,0,-8,5,2
0057,OTHERMLT18,6,19,13,11,16
0058,PERSONS,3543,3763,220,3631,3719
0058,WHITE,2911,3037,126,2961,3012
0058,BLACK,182,119,-63,157,132
0058,HISPANIC,87,156,69,115,142
0058,ASIAN,317,375,58,340,363
0058,AMINDIAN,13,7,-6,11,8
0058,PISLAND,5,1,-4,3,2
0058,OTHER,14,4,-10,10,6
0058,OTHERMLT,14,64,50,34,54
0058,PERSONS18,3479,3687,208,3562,3645
0058,WHITE18,2877,3007,130,2929,2981
0058,BLACK18,172,112,-60,148,124
0058,HISPANIC18,83,143,60,107,131
0058,ASIAN18,302,353,51,322,343
0058,AMINDIAN18,13,7,-6,11,8
0058,PISLAND18,4,1,-3,3,2
0058,OTHER18,14,3,-11,10,5
0058,OTHERMLT18,14,61,47,33,52
0059,PERSONS,1499,2391,892,1856,2213
0059,WHITE,1191,2064,873,1540,1889
0059,BLACK,171,117,-54,149,128
0059,HISPANIC,54,81,27,65,76
0059,ASIAN,56,89,33,69,82
0059,AMINDIAN,15,4,-11,11,6
0059,PISLAND,2,0,-2,1,0
0059,OTHER,6,2,-4,4,3
0059,OTHERMLT,4,34,30,16,28
0059,PERSONS18,1468,2334,866,1814,2161
0059,WHITE18,1173,2030,857,1516,1859
0059,BLACK18,165,100,-65,139,113
0059,HISPANIC18,52,78,26,62,73
0059,ASIAN18,51,87,36,65,80
0059,AMINDIAN18,15,3,-12,10,5
0059,PISLAND18,2,0,-2,1,0
0059,OTHER18,6,2,-4,4,3
0059,OTHERMLT18,4,34,30,16,28
0006,PERSONS,1509,1351,-158,1446,1383
0006,WHITE,217,106,-111,173,128
0006,BLACK,1218,1158,-60,1194,1170
0006,HISPANIC,36,46,10,40,44
0006,ASIAN,22,19,-3,21,20
0006,AMINDIAN,6,9,3,7,8
0006,PISLAND,0,1,1,0,1
0006,OTHER,3,4,1,3,4
0006,OTHERMLT,7,8,1,7,8
0006,PERSONS18,933,903,-30,921,909
0006,WHITE18,189,97,-92,152,115
0006,BLACK18,702,750,48,721,740
0006,HISPANIC18,21,31,10,25,29
0006,ASIAN18,11,12,1,11,12
0006,AMINDIAN18,3,6,3,4,5
0006,PISLAND18,0,1,1,0,1
0006,OTHER18,1,1,0,1,1
0006,OTHERMLT18,6,5,-1,6,5
0060,PERSONS,2518,2746,228,2609,2700
0060,WHITE,1514,1749,235,1608,1702
0060,BLACK,616,559,-57,593,570
0060,HISPANIC,144,201,57,167,190
0060,ASIAN,177,150,-27,166,155
0060,AMINDIAN,15,21,6,17,20
0060,PISLAND,9,7,-2,8,7
0060,OTHER,5,5,0,5,5
0060,OTHERMLT,38,54,16,44,51
0060,PERSONS18,2363,2586,223,2452,2541
0060,WHITE18,1500,1720,220,1588,1676
0060,BLACK18,510,471,-39,494,479
0060,HISPANIC18,125,176,51,145,166
0060,ASIAN18,162,142,-20,154,146
0060,AMINDIAN18,14,19,5,16,18
0060,PISLAND18,9,4,-5,7,5
0060,OTHER18,5,5,0,5,5
0060,OTHERMLT18,38,49,11,42,47
0061,PERSONS,3319,3410,91,3355,3392
0061,WHITE,1606,1431,-175,1536,1466
0061,BLACK,1462,1637,175,1532,1602
0061,HISPANIC,51,146,95,89,127
0061,ASIAN,154,151,-3,153,152
0061,AMINDIAN,23,18,-5,21,19
0061,PISLAND,12,0,-12,7,2
0061,OTHER,1,0,-1,1,0
0061,OTHERMLT,10,27,17,17,24
0061,PERSONS18,3183,3320,137,3238,3293
0061,WHITE18,1586,1423,-163,1521,1456
0061,BLACK18,1372,1566,194,1450,1527
0061,HISPANIC18,47,141,94,85,122
0061,ASIAN18,135,148,13,140,145
0061,AMINDIAN18,23,18,-5,21,19
0061,PISLAND18,11,0,-11,7,2
0061,OTHER18,1,0,-1,1,0
0061,OTHERMLT18,8,24,16,14,21
0062,PERSONS,1558,1796,238,1653,1748
0062,WHITE,1396,1531,135,1450,1504
0062,BLACK,48,75,27,59,70
0062,HISPANIC,43,94,51,63,84
0062,ASIAN,46,83,37,61,76
0062,AMINDIAN,7,6,-1,7,6
0062,PISLAND,11,0,-11,7,2
0062,OTHER,2,1,-1,2,1
0062,OTHERMLT,5,6,1,5,6
0062,PERSONS18,1548,1777,229,1640,1731
0062,WHITE18,1392,1523,131,1444,1497
0062,BLACK18,45,70,25,55,65
0062,HISPANIC18,42,92,50,62,82
0062,ASIAN18,44,79,35,58,72
0062,AMINDIAN18,7,6,-1,7,6
0062,PISLAND18,11,0,-11,7,2
0062,OTHER18,2,1,-1,2,1
0062,OTHERMLT18,5,6,1,5,6
0063,PERSONS,1504,1290,-214,1418,1333
0063,WHITE,212,174,-38,197,182
0063,BLACK,104,134,30,116,128
0063,HISPANIC,1142,947,-195,1064,986
0063,ASIAN,18,4,-14,12,7
0063,AMINDIAN,21,5,-16,15,8
0063,PISLAND,0,0,0,0,0
0063,OTHER,1,4,3,2,3
0063,OTHERMLT,6,22,16,12,19
0063,PERSONS18,995,852,-143,938,881
0063,WHITE18,181,147,-34,167,154
0063,BLACK18,45,80,35,59,73
0063,HISPANIC18,739,604,-135,685,631
0063,ASIAN18,11,4,-7,8,5
0063,AMINDIAN18,16,4,-12,11,6
0063,PISLAND18,0,0,0,0,0
0063,OTHER18,0,4,4,2,3
0063,OTHERMLT18,3,9,6,5,8
0064,PERSONS,2103,2567,464,2289,2474
0064,WHITE,748,621,-127,697,646
0064,BLACK,228,466,238,323,418
0064,HISPANIC,976,1276,300,1096,1216
0064,ASIAN,63,121,58,86,109
0064,AMINDIAN,69,26,-43,52,35
0064,PISLAND,0,0,0,0,0
0064,OTHER,6,0,-6,4,1
0064,OTHERMLT,13,57,44,31,48
0064,PERSONS18,1599,1944,345,1737,1875
0064,WHITE18,685,584,-101,645,604
0064,BLACK18,153,369,216,239,326
0064,HISPANIC18,651,842,191,727,804
0064,ASIAN18,51,94,43,68,85
0064,AMINDIAN18,44,23,-21,36,27
0064,PISLAND18,0,0,0,0,0
0064,OTHER18,6,0,-6,4,1
0064,OTHERMLT18,9,32,23,18,27
0065,PERSONS,1296,1356,60,1320,1344
0065,WHITE,551,508,-43,534,517
0065,BLACK,601,623,22,610,619
0065,HISPANIC,65,93,28,76,87
0065,ASIAN,52,68,16,58,65
0065,AMINDIAN,11,6,-5,9,7
0065,PISLAND,2,3,1,2,3
0065,OTHER,7,1,-6,5,2
0065,OTHERMLT,7,54,47,26,45
0065,PERSONS18,1121,1200,79,1153,1184
0065,WHITE18,543,500,-43,526,509
0065,BLACK18,454,518,64,480,505
0065,HISPANIC18,49,73,24,59,68
0065,ASIAN18,49,63,14,55,60
0065,AMINDIAN18,10,5,-5,8,6
0065,PISLAND18,2,3,1,2,3
0065,OTHER18,7,1,-6,5,2
0065,OTHERMLT18,7,37,30,19,31
0066,PERSONS,1695,1454,-241,1599,1502
0066,WHITE,213,183,-30,201,189
0066,BLACK,1318,1075,-243,1221,1124
0066,HISPANIC,38,112,74,68,97
0066,ASIAN,86,24,-62,61,36
0066,AMINDIAN,4,14,10,8,12
0066,PISLAND,1,0,-1,1,0
0066,OTHER,11,3,-8,8,5
0066,OTHERMLT,24,43,19,32,39
0066,PERSONS18,1161,1109,-52,1140,1119
0066,WHITE18,198,176,-22,189,180
0066,BLACK18,857,808,-49,837,818
0066,HISPANIC18,29,71,42,46,63
0066,ASIAN18,47,21,-26,37,26
0066,AMINDIAN18,4,8,4,6,7
0066,PISLAND18,1,0,-1,1,0
0066,OTHER18,8,3,-5,6,4
0066,OTHERMLT18,17,22,5,19,21
0067,PERSONS,2173,1968,-205,2091,2009
0067,WHITE,183,114,-69,155,128
0067,BLACK,1308,1103,-205,1226,1144
0067,HISPANIC,220,284,64,246,271
0067,ASIAN,400,390,-10,396,392
0067,AMINDIAN,4,5,1,4,5
0067,PISLAND,0,0,0,0,0
0067,OTHER,8,14,6,10,13
0067,OTHERMLT,50,58,8,53,56
0067,PERSONS18,1299,1238,-61,1275,1250
0067,WHITE18,170,105,-65,144,118
0067,BLACK18,752,668,-84,718,685
0067,HISPANIC18,133,170,37,148,163
0067,ASIAN18,209,261,52,230,251
0067,AMINDIAN18,4,4,0,4,4
0067,PISLAND18,0,0,0,0,0
0067,OTHER18,4,4,0,4,4
0067,OTHERMLT18,27,26,-1,27,26
0068,PERSONS,1010,873,-137,955,900
0068,WHITE,215,122,-93,178,141
0068,BLACK,503,481,-22,494,485
0068,HISPANIC,49,31,-18,42,35
0068,ASIAN,203,218,15,209,215
0068,AMINDIAN,8,0,-8,5,2
0068,PISLAND,0,0,0,0,0
0068,OTHER,13,2,-11,9,4
0068,OTHERMLT,19,19,0,19,19
0068,PERSONS18,627,568,-59,603,580
0068,WHITE18,186,111,-75,156,126
0068,BLACK18,302,302,0,302,302
0068,HISPANIC18,30,20,-10,26,22
0068,ASIAN18,88,123,35,102,116
0068,AMINDIAN18,5,0,-5,3,1
0068,PISLAND18,0,0,0,0,0
0068,OTHER18,4,2,-2,3,2
0068,OTHERMLT18,12,10,-2,11,10
0069,PERSONS,1469,1164,-305,1347,1225
0069,WHITE,112,74,-38,97,82
0069,BLACK,726,484,-242,629,532
0069,HISPANIC,57,74,17,64,71
0069,ASIAN,501,499,-2,500,499
0069,AMINDIAN,2,7,5,4,6
0069,PISLAND,24,0,-24,14,5
0069,OTHER,8,1,-7,5,2
0069,OTHERMLT,39,25,-14,33,28
0069,PERSONS18,698,676,-22,689,680
0069,WHITE18,97,62,-35,83,69
0069,BLACK18,336,283,-53,315,294
0069,HISPANIC18,37,49,12,42,47
0069,ASIAN18,196,265,69,224,251
0069,AMINDIAN18,2,4,2,3,4
0069,PISLAND18,8,0,-8,5,2
0069,OTHER18,2,1,-1,2,1
0069,OTHERMLT18,20,12,-8,17,14
0007,PERSONS,1856,1756,-100,1816,1776
0007,WHITE,372,172,-200,292,212
0007,BLACK,1328,1403,75,1358,1388
0007,HISPANIC,85,70,-15,79,73
0007,ASIAN,34,51,17,41,48
0007,AMINDIAN,10,2,-8,7,4
0007,PISLAND,2,0,-2,1,0
0007,OTHER,4,3,-1,4,3
0007,OTHERMLT,21,55,34,35,48
0007,PERSONS18,1180,1174,-6,1178,1175
0007,WHITE18,319,157,-162,254,189
0007,BLACK18,770,914,144,828,885
0007,HISPANIC18,54,44,-10,50,46
0007,ASIAN18,19,26,7,22,25
0007,AMINDIAN18,5,2,-3,4,3
0007,PISLAND18,0,0,0,0,0
0007,OTHER18,2,2,0,2,2
0007,OTHERMLT18,11,29,18,18,25
0070,PERSONS,1458,1599,141,1514,1571
0070,WHITE,311,271,-40,295,279
0070,BLACK,983,1134,151,1043,1104
0070,HISPANIC,97,125,28,108,119
0070,ASIAN,20,13,-7,17,14
0070,AMINDIAN,20,19,-1,20,19
0070,PISLAND,2,0,-2,1,0
0070,OTHER,6,0,-6,4,1
0070,OTHERMLT,19,37,18,26,33
0070,PERSONS18,1167,1349,182,1240,1313
0070,WHITE18,286,252,-34,272,259
0070,BLACK18,770,963,193,847,924
0070,HISPANIC18,57,86,29,69,80
0070,ASIAN18,16,11,-5,14,12
0070,AMINDIAN18,20,17,-3,19,18
0070,PISLAND18,2,0,-2,1,0
0070,OTHER18,5,0,-5,3,1
0070,OTHERMLT18,11,20,9,15,18
0071,PERSONS,2200,1911,-289,2084,1969
0071,WHITE,316,266,-50,296,276
0071,BLACK,1524,1435,-89,1488,1453
0071,HISPANIC,263,135,-128,212,161
0071,ASIAN,41,3,-38,26,11
0071,AMINDIAN,25,20,-5,23,21
0071,PISLAND,0,0,0,0,0
0071,OTHER,8,5,-3,7,6
0071,OTHERMLT,23,47,24,33,42
0071,PERSONS18,1662,1537,-125,1612,1562
0071,WHITE18,297,251,-46,279,260
0071,BLACK18,1117,1130,13,1122,1127
0071,HISPANIC18,184,107,-77,153,122
0071,ASIAN18,22,2,-20,14,6
0071,AMINDIAN18,18,14,-4,16,15
0071,PISLAND18,0,0,0,0,0
0071,OTHER18,6,3,-3,5,4
0071,OTHERMLT18,18,30,12,23,28
0072,PERSONS,2153,1857,-296,2035,1916
0072,WHITE,352,201,-151,292,231
0072,BLACK,1138,1155,17,1145,1152
0072,HISPANIC,379,308,-71,351,322
0072,ASIAN,233,109,-124,183,134
0072,AMINDIAN,21,10,-11,17,12
0072,PISLAND,0,3,3,1,2
0072,OTHER,12,0,-12,7,2
0072,OTHERMLT,18,71,53,39,60
0072,PERSONS18,1429,1357,-72,1400,1371
0072,WHITE18,305,186,-119,257,210
0072,BLACK18,718,827,109,762,805
0072,HISPANIC18,244,214,-30,232,220
0072,ASIAN18,131,83,-48,112,93
0072,AMINDIAN18,15,7,-8,12,9
0072,PISLAND18,0,2,2,1,2
0072,OTHER18,7,0,-7,4,1
0072,OTHERMLT18,9,38,29,21,32
0073,PERSONS,1247,1060,-187,1172,1097
0073,WHITE,185,92,-93,148,111
0073,BLACK,718,689,-29,706,695
0073,HISPANIC,116,134,18,123,130
0073,ASIAN,182,102,-80,150,118
0073,AMINDIAN,30,4,-26,20,9
0073,PISLAND,0,0,0,0,0
0073,OTHER,3,2,-1,3,2
0073,OTHERMLT,13,37,24,23,32
0073,PERSONS18,801,775,-26,791,780
0073,WHITE18,149,86,-63,124,99
0073,BLACK18,466,492,26,476,487
0073,HISPANIC18,69,93,24,79,88
0073,ASIAN18,82,73,-9,78,75
0073,AMINDIAN18,25,4,-21,17,8
0073,PISLAND18,0,0,0,0,0
0073,OTHER18,1,0,-1,1,0
0073,OTHERMLT18,9,27,18,16,23
0074,PERSONS,2824,2724,-100,2784,2744
0074,WHITE,819,342,-477,628,437
0074,BLACK,1820,2078,258,1923,2026
0074,HISPANIC,109,89,-20,101,93
0074,ASIAN,38,79,41,54,71
0074,AMINDIAN,12,21,9,16,19
0074,PISLAND,0,1,1,0,1
0074,OTHER,13,0,-13,8,3
0074,OTHERMLT,13,114,101,53,94
0074,PERSONS18,1829,1721,-108,1786,1743
0074,WHITE18,717,323,-394,559,402
0074,BLACK18,1010,1253,243,1107,1204
0074,HISPANIC18,60,53,-7,57,54
0074,ASIAN18,22,40,18,29,36
0074,AMINDIAN18,9,16,7,12,15
0074,PISLAND18,0,1,1,0,1
0074,OTHER18,5,0,-5,3,1
0074,OTHERMLT18,6,35,29,18,29
0075,PERSONS,1842,1759,-83,1809,1776
0075,WHITE,816,342,-474,626,437
0075,BLACK,872,1164,292,989,1106
0075,HISPANIC,57,37,-20,49,41
0075,ASIAN,53,148,95,91,129
0075,AMINDIAN,10,1,-9,6,3
0075,PISLAND,1,0,-1,1,0
0075,OTHER,14,4,-10,10,6
0075,OTHERMLT,19,63,44,37,54
0075,PERSONS18,1313,1165,-148,1254,1195
0075,WHITE18,684,297,-387,529,374
0075,BLACK18,542,734,192,619,696
0075,HISPANIC18,31,18,-13,26,21
0075,ASIAN18,30,88,58,53,76
0075,AMINDIAN18,7,1,-6,5,2
0075,PISLAND18,1,0,-1,1,0
0075,OTHER18,6,3,-3,5,4
0075,OTHERMLT18,12,24,12,17,22
0076,PERSONS,2116,2139,23,2125,2134
0076,WHITE,1622,1041,-581,1390,1157
0076,BLACK,357,803,446,535,714
0076,HISPANIC,58,110,52,79,100
0076,ASIAN,45,72,27,56,67
0076,AMINDIAN,11,12,1,11,12
0076,PISLAND,1,4,3,2,3
0076,OTHER,12,4,-8,9,6
0076,OTHERMLT,10,93,83,43,76
0076,PERSONS18,1564,1486,-78,1533,1502
0076,WHITE18,1273,845,-428,1102,931
0076,BLACK18,210,494,284,324,437
0076,HISPANIC18,32,61,29,44,55
0076,ASIAN18,30,43,13,35,40
0076,AMINDIAN18,6,10,4,8,9
0076,PISLAND18,1,4,3,2,3
0076,OTHER18,9,3,-6,7,4
0076,OTHERMLT18,3,26,23,12,21
0077,PERSONS,2608,2559,-49,2588,2569
0077,WHITE,1546,986,-560,1322,1098
0077,BLACK,822,1200,378,973,1124
0077,HISPANIC,123,173,50,143,163
0077,ASIAN,67,80,13,72,77
0077,AMINDIAN,22,17,-5,20,18
0077,PISLAND,4,1,-3,3,2
0077,OTHER,11,7,-4,9,8
0077,OTHERMLT,13,95,82,46,79
0077,PERSONS18,1894,1864,-30,1882,1870
0077,WHITE18,1311,853,-458,1128,945
0077,BLACK18,444,780,336,578,713
0077,HISPANIC18,64,104,40,80,96
0077,ASIAN18,49,68,19,57,64
0077,AMINDIAN18,10,11,1,10,11
0077,PISLAND18,4,1,-3,3,2
0077,OTHER18,6,3,-3,5,4
0077,OTHERMLT18,6,44,38,21,36
0078,PERSONS,1435,1488,53,1456,1477
0078,WHITE,612,285,-327,481,350
0078,BLACK,678,1006,328,809,940
0078,HISPANIC,39,38,-1,39,38
0078,ASIAN,85,99,14,91,96
0078,AMINDIAN,8,8,0,8,8
0078,PISLAND,0,0,0,0,0
0078,OTHER,3,1,-2,2,1
0078,OTHERMLT,10,51,41,26,43
0078,PERSONS18,968,1000,32,981,994
0078,WHITE18,494,247,-247,395,296
0078,BLACK18,393,645,252,494,595
0078,HISPANIC18,18,25,7,21,24
0078,ASIAN18,51,58,7,54,57
0078,AMINDIAN18,8,6,-2,7,6
0078,PISLAND18,0,0,0,0,0
0078,OTHER18,0,1,1,0,1
0078,OTHERMLT18,4,18,14,10,15
0079,PERSONS,1309,1400,91,1345,1382
0079,WHITE,722,371,-351,582,441
0079,BLACK,486,781,295,604,722
0079,HISPANIC,35,56,21,43,52
0079,ASIAN,38,159,121,86,135
0079,AMINDIAN,11,5,-6,9,6
0079,PISLAND,0,0,0,0,0
0079,OTHER,6,2,-4,4,3
0079,OTHERMLT,11,26,15,17,23
0079,PERSONS18,972,1000,28,983,994
0079,WHITE18,600,345,-255,498,396
0079,BLACK18,309,526,217,396,483
0079,HISPANIC18,24,30,6,26,29
0079,ASIAN18,23,85,62,48,73
0079,AMINDIAN18,8,4,-4,6,5
0079,PISLAND18,0,0,0,0,0
0079,OTHER18,1,0,-1,1,0
0079,OTHERMLT18,7,10,3,8,9
0008,PERSONS,1713,1629,-84,1679,1646
0008,WHITE,506,277,-229,414,323
0008,BLACK,1005,1093,88,1040,1075
0008,HISPANIC,54,64,10,58,62
0008,ASIAN,106,138,32,119,132
0008,AMINDIAN,23,10,-13,18,13
0008,PISLAND,0,0,0,0,0
0008,OTHER,0,2,2,1,2
0008,OTHERMLT,19,45,26,29,40
0008,PERSONS18,1111,1134,23,1120,1129
0008,WHITE18,426,249,-177,355,284
0008,BLACK18,583,727,144,641,698
0008,HISPANIC18,23,39,16,29,36
0008,ASIAN18,55,87,32,68,81
0008,AMINDIAN18,14,10,-4,12,11
0008,PISLAND18,0,0,0,0,0
0008,OTHER18,0,1,1,0,1
0008,OTHERMLT18,10,21,11,14,19
0080,PERSONS,1588,1650,62,1613,1638
0080,WHITE,701,314,-387,546,391
0080,BLACK,757,1128,371,905,1054
0080,HISPANIC,49,72,23,58,67
0080,ASIAN,52,49,-3,51,50
0080,AMINDIAN,3,5,2,4,5
0080,PISLAND,0,0,0,0,0
0080,OTHER,6,1,-5,4,2
0080,OTHERMLT,20,81,61,44,69
0080,PERSONS18,1080,1057,-23,1071,1062
0080,WHITE18,565,276,-289,449,334
0080,BLACK18,445,694,249,545,644
0080,HISPANIC18,28,32,4,30,31
0080,ASIAN18,29,20,-9,25,22
0080,AMINDIAN18,3,5,2,4,5
0080,PISLAND18,0,0,0,0,0
0080,OTHER18,4,0,-4,2,1
0080,OTHERMLT18,6,30,24,16,25
0081,PERSONS,1278,1309,31,1290,1303
0081,WHITE,889,524,-365,743,597
0081,BLACK,309,606,297,428,547
0081,HISPANIC,36,33,-3,35,34
0081,ASIAN,20,63,43,37,54
0081,AMINDIAN,16,13,-3,15,14
0081,PISLAND,0,3,3,1,2
0081,OTHER,6,5,-1,6,5
0081,OTHERMLT,2,62,60,26,50
0081,PERSONS18,991,955,-36,977,962
0081,WHITE18,726,455,-271,618,509
0081,BLACK18,220,403,183,293,366
0081,HISPANIC18,18,17,-1,18,17
0081,ASIAN18,15,36,21,23,32
0081,AMINDIAN18,7,9,2,8,9
0081,PISLAND18,0,3,3,1,2
0081,OTHER18,4,4,0,4,4
0081,OTHERMLT18,1,28,27,12,23
0082,PERSONS,1475,1559,84,1509,1542
0082,WHITE,1197,619,-578,966,735
0082,BLACK,179,757,578,410,641
0082,HISPANIC,59,80,21,67,76
0082,ASIAN,19,48,29,31,42
0082,AMINDIAN,15,11,-4,13,12
0082,PISLAND,0,0,0,0,0
0082,OTHER,3,3,0,3,3
0082,OTHERMLT,3,41,38,18,33
0082,PERSONS18,1190,1181,-9,1186,1183
0082,WHITE18,1003,560,-443,826,649
0082,BLACK18,120,527,407,283,446
0082,HISPANIC18,40,41,1,40,41
0082,ASIAN18,15,28,13,20,25
0082,AMINDIAN18,8,9,1,8,9
0082,PISLAND18,0,0,0,0,0
0082,OTHER18,2,2,0,2,2
0082,OTHERMLT18,2,14,12,7,12
0087,PERSONS,1174,1170,-4,1172,1171
0087,WHITE,1094,939,-155,1032,970
0087,BLACK,36,147,111,80,125
0087,HISPANIC,27,35,8,30,33
0087,ASIAN,8,20,12,13,18
0087,AMINDIAN,5,9,4,7,8
0087,PISLAND,2,0,-2,1,0
0087,OTHER,0,5,5,2,4
0087,OTHERMLT,2,15,13,7,12
0087,PERSONS18,934,905,-29,922,911
0087,WHITE18,880,753,-127,829,778
0087,BLACK18,27,100,73,56,85
0087,HISPANIC18,16,22,6,18,21
0087,ASIAN18,4,17,13,9,14
0087,AMINDIAN18,4,6,2,5,6
0087,PISLAND18,2,0,-2,1,0
0087,OTHER18,0,0,0,0,0
0087,OTHERMLT18,1,7,6,3,6
0088,PERSONS,1822,1888,66,1848,1875
0088,WHITE,1480,880,-600,1240,1000
0088,BLACK,202,767,565,428,654
0088,HISPANIC,57,56,-1,57,56
0088,ASIAN,60,87,27,71,82
0088,AMINDIAN,15,7,-8,12,9
0088,PISLAND,0,1,1,0,1
0088,OTHER,2,3,1,2,3
0088,OTHERMLT,6,87,81,38,71
0088,PERSONS18,1573,1480,-93,1536,1499
0088,WHITE18,1341,781,-560,1117,893
0088,BLACK18,139,563,424,309,478
0088,HISPANIC18,32,30,-2,31,30
0088,ASIAN18,44,52,8,47,50
0088,AMINDIAN18,12,6,-6,10,7
0088,PISLAND18,0,1,1,0,1
0088,OTHER18,1,3,2,2,3
0088,OTHERMLT18,4,44,40,20,36
0089,PERSONS,1620,1626,6,1622,1625
0089,WHITE,1385,1017,-368,1238,1091
0089,BLACK,120,398,278,231,342
0089,HISPANIC,55,89,34,69,82
0089,ASIAN,36,32,-4,34,33
0089,AMINDIAN,9,9,0,9,9
0089,PISLAND,6,0,-6,4,1
0089,OTHER,5,5,0,5,5
0089,OTHERMLT,4,76,72,33,62
0089,PERSONS18,1264,1234,-30,1252,1240
0089,WHITE18,1116,847,-269,1008,901
0089,BLACK18,79,278,199,159,238
0089,HISPANIC18,31,46,15,37,43
0089,ASIAN18,24,25,1,24,25
0089,AMINDIAN18,7,7,0,7,7
0089,PISLAND18,1,0,-1,1,0
0089,OTHER18,5,4,-1,5,4
0089,OTHERMLT18,1,27,26,11,22
0009,PERSONS,1768,1804,36,1782,1797
0009,WHITE,559,209,-350,419,279
0009,BLACK,1024,1355,331,1156,1289
0009,HISPANIC,78,97,19,86,93
0009,ASIAN,80,92,12,85,90
0009,AMINDIAN,13,9,-4,11,10
0009,PISLAND,0,1,1,0,1
0009,OTHER,9,7,-2,8,7
0009,OTHERMLT,5,34,29,17,28
0009,PERSONS18,1172,1169,-3,1171,1170
0009,WHITE18,480,191,-289,364,249
0009,BLACK18,600,853,253,701,802
0009,HISPANIC18,38,57,19,46,53
0009,ASIAN18,38,43,5,40,42
0009,AMINDIAN18,9,5,-4,7,6
0009,PISLAND18,0,1,1,0,1
0009,OTHER18,3,2,-1,3,2
0009,OTHERMLT18,4,17,13,9,14
0090,PERSONS,1379,1357,-22,1370,1361
0090,WHITE,1262,1048,-214,1176,1091
0090,BLACK,31,149,118,78,125
0090,HISPANIC,49,90,41,65,82
0090,ASIAN,28,31,3,29,30
0090,AMINDIAN,6,1,-5,4,2
0090,PISLAND,0,0,0,0,0
0090,OTHER,0,3,3,1,2
0090,OTHERMLT,3,35,32,16,29
0090,PERSONS18,1060,1042,-18,1053,1046
0090,WHITE18,988,870,-118,941,894
0090,BLACK18,21,98,77,52,83
0090,HISPANIC18,27,43,16,33,40
0090,ASIAN18,17,21,4,19,20
0090,AMINDIAN18,4,1,-3,3,2
0090,PISLAND18,0,0,0,0,0
0090,OTHER18,0,1,1,0,1
0090,OTHERMLT18,3,8,5,5,7
0091,PERSONS,1281,1318,37,1296,1311
0091,WHITE,1155,1159,4,1157,1158
0091,BLACK,41,55,14,47,52
0091,HISPANIC,42,53,11,46,51
0091,ASIAN,29,26,-3,28,27
0091,AMINDIAN,6,7,1,6,7
0091,PISLAND,1,0,-1,1,0
0091,OTHER,2,0,-2,1,0
0091,OTHERMLT,5,18,13,10,15
0091,PERSONS18,1007,1009,2,1008,1009
0091,WHITE18,932,908,-24,922,913
0091,BLACK18,23,45,22,32,41
0091,HISPANIC18,25,26,1,25,26
0091,ASIAN18,18,18,0,18,18
0091,AMINDIAN18,6,5,-1,6,5
0091,PISLAND18,0,0,0,0,0
0091,OTHER18,0,0,0,0,0
0091,OTHERMLT18,3,7,4,5,6
0092,PERSONS,2366,2481,115,2412,2458
0092,WHITE,2067,1780,-287,1952,1837
0092,BLACK,142,479,337,277,412
0092,HISPANIC,89,106,17,96,103
0092,ASIAN,27,24,-3,26,25
0092,AMINDIAN,22,12,-10,18,14
0092,PISLAND,0,3,3,1,2
0092,OTHER,8,6,-2,7,6
0092,OTHERMLT,11,71,60,35,59
0092,PERSONS18,1905,1922,17,1912,1919
0092,WHITE18,1721,1460,-261,1617,1512
0092,BLACK18,98,339,241,194,291
0092,HISPANIC18,45,58,13,50,55
0092,ASIAN18,18,20,2,19,20
0092,AMINDIAN18,12,9,-3,11,10
0092,PISLAND18,0,2,2,1,2
0092,OTHER18,6,2,-4,4,3
0092,OTHERMLT18,5,32,27,16,27
0093,PERSONS,1387,1384,-3,1386,1385
0093,WHITE,1322,1174,-148,1263,1204
0093,BLACK,18,106,88,53,88
0093,HISPANIC,25,27,2,26,27
0093,ASIAN,7,37,30,19,31
0093,AMINDIAN,8,4,-4,6,5
0093,PISLAND,4,1,-3,3,2
0093,OTHER,3,2,-1,3,2
0093,OTHERMLT,0,33,33,13,26
0093,PERSONS18,1121,1110,-11,1117,1112
0093,WHITE18,1079,961,-118,1032,985
0093,BLACK18,8,83,75,38,68
0093,HISPANIC18,16,17,1,16,17
0093,ASIAN18,5,28,23,14,23
0093,AMINDIAN18,7,4,-3,6,5
0093,PISLAND18,3,1,-2,2,1
0093,OTHER18,3,2,-1,3,2
0093,OTHERMLT18,0,14,14,6,11
0094,PERSONS,1495,1532,37,1510,1525
0094,WHITE,1376,1319,-57,1353,1330
0094,BLACK,29,85,56,51,74
0094,HISPANIC,34,50,16,40,47
0094,ASIAN,34,32,-2,33,32
0094,AMINDIAN,9,6,-3,8,7
0094,PISLAND,4,4,0,4,4
0094,OTHER,4,1,-3,3,2
0094,OTHERMLT,5,35,30,17,29
0094,PERSONS18,1217,1215,-2,1216,1215
0094,WHITE18,1138,1059,-79,1106,1075
0094,BLACK18,17,68,51,37,58
0094,HISPANIC18,23,37,14,29,34
0094,ASIAN18,28,25,-3,27,26
0094,AMINDIAN18,5,5,0,5,5
0094,PISLAND18,2,4,2,3,4
0094,OTHER18,1,0,-1,1,0
0094,OTHERMLT18,3,17,14,9,14
0095,PERSONS,1866,1892,26,1876,1887
0095,WHITE,745,755,10,749,753
0095,BLACK,677,788,111,721,766
0095,HISPANIC,343,248,-95,305,267
0095,ASIAN,23,21,-2,22,21
0095,AMINDIAN,31,15,-16,25,18
0095,PISLAND,0,0,0,0,0
0095,OTHER,7,7,0,7,7
0095,OTHERMLT,40,58,18,47,54
0095,PERSONS18,1420,1555,135,1474,1528
0095,WHITE18,660,690,30,672,684
0095,BLACK18,483,626,143,540,597
0095,HISPANIC18,202,171,-31,190,177
0095,ASIAN18,21,20,-1,21,20
0095,AMINDIAN18,27,15,-12,22,17
0095,PISLAND18,0,0,0,0,0
0095,OTHER18,5,5,0,5,5
0095,OTHERMLT18,22,28,6,24,27
0096,PERSONS,1726,1963,237,1821,1916
0096,WHITE,315,437,122,364,413
0096,BLACK,1079,1106,27,1090,1101
0096,HISPANIC,263,260,-3,262,261
0096,ASIAN,24,77,53,45,66
0096,AMINDIAN,19,13,-6,17,14
0096,PISLAND,0,0,0,0,0
0096,OTHER,10,8,-2,9,8
0096,OTHERMLT,16,62,46,34,53
0096,PERSONS18,1090,1398,308,1213,1336
0096,WHITE18,284,421,137,339,394
0096,BLACK18,598,705,107,641,684
0096,HISPANIC18,163,162,-1,163,162
0096,ASIAN18,21,62,41,37,54
0096,AMINDIAN18,9,9,0,9,9
0096,PISLAND18,0,0,0,0,0
0096,OTHER18,5,5,0,5,5
0096,OTHERMLT18,10,34,24,20,29
0097,PERSONS,1865,1810,-55,1843,1821
0097,WHITE,37,33,-4,35,34
0097,BLACK,1765,1675,-90,1729,1693
0097,HISPANIC,36,75,39,52,67
0097,ASIAN,2,2,0,2,2
0097,AMINDIAN,8,6,-2,7,6
0097,PISLAND,0,0,0,0,0
0097,OTHER,0,10,10,4,8
0097,OTHERMLT,17,9,-8,14,11
0097,PERSONS18,1141,1218,77,1172,1203
0097,WHITE18,29,32,3,30,31
0097,BLACK18,1068,1123,55,1090,1112
0097,HISPANIC18,27,48,21,35,44
0097,ASIAN18,2,2,0,2,2
0097,AMINDIAN18,4,4,0,4,4
0097,PISLAND18,0,0,0,0,0
0097,OTHER18,0,3,3,1,2
0097,OTHERMLT18,11,6,-5,9,7
0098,PERSONS,1842,1845,3,1843,1844
0098,WHITE,48,101,53,69,90
0098,BLACK,1709,1579,-130,1657,1605
0098,HISPANIC,74,112,38,89,104
0098,ASIAN,1,7,6,3,6
0098,AMINDIAN,1,10,9,5,8
0098,PISLAND,1,0,-1,1,0
0098,OTHER,0,5,5,2,4
0098,OTHERMLT,8,31,23,17,26
0098,PERSONS18,1073,1170,97,1112,1151
0098,WHITE18,40,96,56,62,85
0098,BLACK18,987,980,-7,984,981
0098,HISPANIC18,41,66,25,51,61
0098,ASIAN18,0,4,4,2,3
0098,AMINDIAN18,1,7,6,3,6
0098,PISLAND18,0,0,0,0,0
0098,OTHER18,0,3,3,1,2
0098,OTHERMLT18,4,14,10,8,12
0099,PERSONS,1994,1594,-400,1834,1674
0099,WHITE,49,28,-21,41,32
0099,BLACK,1883,1520,-363,1738,1593
0099,HISPANIC,37,37,0,37,37
0099,ASIAN,0,0,0,0,0
0099,AMINDIAN,10,0,-10,6,2
0099,PISLAND,1,0,-1,1,0
0099,OTHER,2,0,-2,1,0
0099,OTHERMLT,12,9,-3,11,10
0099,PERSONS18,1211,1030,-181,1139,1066
0099,WHITE18,30,24,-6,28,25
0099,BLACK18,1147,984,-163,1082,1017
0099,HISPANIC18,23,17,-6,21,18
0099,ASIAN18,0,0,0,0,0
0099,AMINDIAN18,4,0,-4,2,1
0099,PISLAND18,1,0,-1,1,0
0099,OTHER18,2,0,-2,1,0
0099,OTHERMLT18,4,5,1,4,5
0262,PERSONS,0,0,0,0,0
0262,WHITE,0,0,0,0,0
0262,BLACK,0,0,0,0,0
0262,HISPANIC,0,0,0,0,0
0262,ASIAN,0,0,0,0,0
0262,AMINDIAN,0,0,0,0,0
0262,PISLAND,0,0,0,0,0
0262,OTHER,0,0,0,0,0
0262,OTHERMLT,0,0,0,0,0
0262,PERSONS18,0,0,0,0,0
0262,WHITE18,0,0,0,0,0
0262,BLACK18,0,0,0,0,0
0262,HISPANIC18,0,0,0,0,0
0262,ASIAN18,0,0,0,0,0
0262,AMINDIAN18,0,0,0,0,0
0262,PISLAND18,0,0,0,0,0
0262,OTHER18,0,0,0,0,0
0262,OTHERMLT18,0,0,0,0,0
0274,PERSONS,0,0,0,0,0
0274,WHITE,0,0,0,0,0
0274,BLACK,0,0,0,0,0
0274,HISPANIC,0,0,0,0,0
0274,ASIAN,0,0,0,0,0
0274,AMINDIAN,0,0,0,0,0
0274,PISLAND,0,0,0,0,0
0274,OTHER,0,0,0,0,0
0274,OTHERMLT,0,0,0,0,0
0274,PERSONS18,0,0,0,0,0
0274,WHITE18,0,0,0,0,0
0274,BLACK18,0,0,0,0,0
0274,HISPANIC18,0,0,0,0,0
0274,ASIAN18,0,0,0,0,0
0274,AMINDIAN18,0,0,0,0,0
0274,PISLAND18,0,0,0,0,0
0274,OTHER18,0,0,0,0,0
0274,OTHERMLT18,0,0,0,0,0
