ward,name,2010,2020,decade_change,interpolated_2016,interpolated_2012
0001,pop,3808,3634,-174,3704,3773
0001,pop_aian,8,11,3,10,9
0001,pop_asian,155,154,-1,154,155
0001,pop_black,1872,2307,435,2133,1959
0001,pop_hisp,691,537,-154,599,660
0001,pop_nhpi,0,0,0,0,0
0001,pop_other,16,13,-3,14,15
0001,pop_two,107,129,22,120,111
0001,pop_white,959,483,-476,673,864
0001,vap,2604,2499,-105,2541,2583
0001,vap_aian,6,7,1,7,6
0001,vap_asian,120,102,-18,109,116
0001,vap_black,1138,1553,415,1387,1221
0001,vap_hisp,426,342,-84,376,409
0001,vap_nhpi,0,0,0,0,0
0001,vap_other,4,12,8,9,6
0001,vap_two,50,60,10,56,52
0001,vap_white,860,423,-437,598,773
0002,pop,1642,1638,-4,1640,1641
0002,pop_aian,0,0,0,0,0
0002,pop_asian,7,8,1,8,7
0002,pop_black,1287,1254,-33,1267,1280
0002,pop_hisp,149,251,102,210,169
0002,pop_nhpi,0,0,0,0,0
0002,pop_other,2,22,20,14,6
0002,pop_two,53,31,-22,40,49
0002,pop_white,144,72,-72,101,130
0002,vap,862,899,37,884,869
0002,vap_aian,0,0,0,0,0
0002,vap_asian,7,4,-3,5,6
0002,vap_black,614,659,45,641,623
0002,vap_hisp,100,134,34,120,107
0002,vap_nhpi,0,0,0,0,0
0002,vap_other,1,11,10,7,3
0002,vap_two,24,20,-4,22,23
0002,vap_white,116,71,-45,89,107
0003,pop,2388,2151,-237,2246,2341
0003,pop_aian,8,6,-2,7,8
0003,pop_asian,89,161,72,132,103
0003,pop_black,1392,1285,-107,1328,1371
0003,pop_hisp,95,143,48,124,105
0003,pop_nhpi,0,0,0,0,0
0003,pop_other,0,13,13,8,3
0003,pop_two,47,85,38,70,55
0003,pop_white,757,458,-299,578,697
0003,vap,1717,1539,-178,1610,1681
0003,vap_aian,6,2,-4,4,5
0003,vap_asian,51,101,50,81,61
0003,vap_black,867,850,-17,857,864
0003,vap_hisp,54,92,38,77,62
0003,vap_nhpi,0,0,0,0,0
0003,vap_other,0,3,3,2,1
0003,vap_two,19,51,32,38,25
0003,vap_white,720,440,-280,552,664
0004,pop,3178,3411,233,3318,3225
0004,pop_aian,5,6,1,6,5
0004,pop_asian,94,106,12,101,96
0004,pop_black,1841,2317,476,2127,1936
0004,pop_hisp,84,127,43,110,93
0004,pop_nhpi,3,1,-2,2,3
0004,pop_other,3,16,13,11,6
0004,pop_two,99,103,4,101,100
0004,pop_white,1049,735,-314,861,986
0004,vap,2497,2692,195,2614,2536
0004,vap_aian,3,6,3,5,4
0004,vap_asian,81,82,1,82,81
0004,vap_black,1297,1764,467,1577,1390
0004,vap_hisp,60,92,32,79,66
0004,vap_nhpi,3,1,-2,2,3
0004,vap_other,3,12,9,8,5
0004,vap_two,54,63,9,59,56
0004,vap_white,996,672,-324,802,931
0005,pop,1774,1734,-40,1750,1766
0005,pop_aian,12,2,-10,6,10
0005,pop_asian,35,73,38,58,43
0005,pop_black,1173,1239,66,1213,1186
0005,pop_hisp,66,80,14,74,69
0005,pop_nhpi,0,1,1,1,0
0005,pop_other,5,7,2,6,5
0005,pop_two,38,66,28,55,44
0005,pop_white,445,266,-179,338,409
0005,vap,1366,1344,-22,1353,1362
0005,vap_aian,6,2,-4,4,5
0005,vap_asian,21,45,24,35,26
0005,vap_black,866,931,65,905,879
0005,vap_hisp,37,61,24,51,42
0005,vap_nhpi,0,1,1,1,0
0005,vap_other,4,7,3,6,5
0005,vap_two,12,43,31,31,18
0005,vap_white,420,254,-166,320,387
0006,pop,3703,3749,46,3731,3712
0006,pop_aian,19,5,-14,11,16
0006,pop_asian,230,295,65,269,243
0006,pop_black,1962,2098,136,2044,1989
0006,pop_hisp,97,212,115,166,120
0006,pop_nhpi,8,0,-8,3,6
0006,pop_other,5,28,23,19,10
0006,pop_two,92,145,53,124,103
0006,pop_white,1290,966,-324,1096,1225
0006,vap,2593,2755,162,2690,2625
0006,vap_aian,15,5,-10,9,13
0006,vap_asian,171,207,36,193,178
0006,vap_black,1181,1438,257,1335,1232
0006,vap_hisp,62,147,85,113,79
0006,vap_nhpi,5,0,-5,2,4
0006,vap_other,3,13,10,9,5
0006,vap_two,36,75,39,59,44
0006,vap_white,1120,870,-250,970,1070
0007,pop,1574,1393,-181,1465,1538
0007,pop_aian,18,2,-16,8,15
0007,pop_asian,31,108,77,77,46
0007,pop_black,724,699,-25,709,719
0007,pop_hisp,116,120,4,118,117
0007,pop_nhpi,0,1,1,1,0
0007,pop_other,3,0,-3,1,2
0007,pop_two,68,60,-8,63,66
0007,pop_white,614,403,-211,487,572
0007,vap,1042,981,-61,1005,1030
0007,vap_aian,13,2,-11,6,11
0007,vap_asian,20,74,54,52,31
0007,vap_black,403,444,41,428,411
0007,vap_hisp,72,68,-4,70,71
0007,vap_nhpi,0,1,1,1,0
0007,vap_other,1,0,-1,0,1
0007,vap_two,21,29,8,26,23
0007,vap_white,512,363,-149,423,482
0008,pop,2565,2618,53,2597,2576
0008,pop_aian,7,2,-5,4,6
0008,pop_asian,70,201,131,149,96
0008,pop_black,1420,1483,63,1458,1433
0008,pop_hisp,139,144,5,142,140
0008,pop_nhpi,1,2,1,2,1
0008,pop_other,6,10,4,8,7
0008,pop_two,80,122,42,105,88
0008,pop_white,842,654,-188,729,804
0008,vap,1865,1957,92,1920,1883
0008,vap_aian,6,2,-4,4,5
0008,vap_asian,45,129,84,95,62
0008,vap_black,980,1072,92,1035,998
0008,vap_hisp,84,91,7,88,85
0008,vap_nhpi,1,2,1,2,1
0008,vap_other,0,5,5,3,1
0008,vap_two,39,84,45,66,48
0008,vap_white,710,572,-138,627,682
0009,pop,1545,1590,45,1572,1554
0009,pop_aian,9,1,-8,4,7
0009,pop_asian,96,233,137,178,123
0009,pop_black,975,989,14,983,978
0009,pop_hisp,69,71,2,70,69
0009,pop_nhpi,2,0,-2,1,2
0009,pop_other,6,7,1,7,6
0009,pop_two,36,64,28,53,42
0009,pop_white,352,225,-127,276,327
0009,vap,1052,1097,45,1079,1061
0009,vap_aian,9,1,-8,4,7
0009,vap_asian,57,151,94,113,76
0009,vap_black,638,667,29,655,644
0009,vap_hisp,34,46,12,41,36
0009,vap_nhpi,2,0,-2,1,2
0009,vap_other,2,4,2,3,2
0009,vap_two,14,33,19,25,18
0009,vap_white,296,195,-101,235,276
0010,pop,2433,2420,-13,2425,2430
0010,pop_aian,7,1,-6,3,6
0010,pop_asian,230,494,264,388,283
0010,pop_black,994,1036,42,1019,1002
0010,pop_hisp,93,114,21,106,97
0010,pop_nhpi,0,0,0,0,0
0010,pop_other,9,17,8,14,11
0010,pop_two,52,79,27,68,57
0010,pop_white,1048,679,-369,827,974
0010,vap,1798,1779,-19,1787,1794
0010,vap_aian,5,0,-5,2,4
0010,vap_asian,138,284,146,226,167
0010,vap_black,679,754,75,724,694
0010,vap_hisp,61,78,17,71,64
0010,vap_nhpi,0,0,0,0,0
0010,vap_other,3,4,1,4,3
0010,vap_two,23,44,21,36,27
0010,vap_white,889,615,-274,725,834
0011,pop,2270,2199,-71,2227,2256
0011,pop_aian,6,1,-5,3,5
0011,pop_asian,255,461,206,379,296
0011,pop_black,1156,1106,-50,1126,1146
0011,pop_hisp,89,140,51,120,99
0011,pop_nhpi,0,0,0,0,0
0011,pop_other,0,7,7,4,1
0011,pop_two,65,89,24,79,70
0011,pop_white,699,395,-304,517,638
0011,vap,1637,1644,7,1641,1638
0011,vap_aian,5,1,-4,3,4
0011,vap_asian,151,274,123,225,176
0011,vap_black,795,835,40,819,803
0011,vap_hisp,58,107,49,87,68
0011,vap_nhpi,0,0,0,0,0
0011,vap_other,0,4,4,2,1
0011,vap_two,24,63,39,47,32
0011,vap_white,604,360,-244,458,555
0012,pop,2264,2123,-141,2179,2236
0012,pop_aian,8,5,-3,6,7
0012,pop_asian,365,577,212,492,407
0012,pop_black,1338,1164,-174,1234,1303
0012,pop_hisp,62,79,17,72,65
0012,pop_nhpi,0,0,0,0,0
0012,pop_other,0,3,3,2,1
0012,pop_two,77,74,-3,75,76
0012,pop_white,415,221,-194,299,376
0012,vap,1440,1372,-68,1399,1426
0012,vap_aian,4,2,-2,3,4
0012,vap_asian,210,349,139,293,238
0012,vap_black,798,761,-37,776,791
0012,vap_hisp,29,41,12,36,31
0012,vap_nhpi,0,0,0,0,0
0012,vap_other,0,3,3,2,1
0012,vap_two,28,29,1,29,28
0012,vap_white,372,187,-185,261,335
0013,pop,1027,1083,56,1061,1038
0013,pop_aian,2,0,-2,1,2
0013,pop_asian,101,217,116,171,124
0013,pop_black,533,561,28,550,539
0013,pop_hisp,21,27,6,25,22
0013,pop_nhpi,1,0,-1,0,1
0013,pop_other,1,4,3,3,2
0013,pop_two,42,43,1,43,42
0013,pop_white,326,231,-95,269,307
0013,vap,773,778,5,776,774
0013,vap_aian,2,0,-2,1,2
0013,vap_asian,57,129,72,100,71
0013,vap_black,395,400,5,398,396
0013,vap_hisp,15,19,4,17,16
0013,vap_nhpi,1,0,-1,0,1
0013,vap_other,1,3,2,2,1
0013,vap_two,16,20,4,18,17
0013,vap_white,286,207,-79,239,270
0014,pop,2289,2214,-75,2244,2274
0014,pop_aian,3,1,-2,2,3
0014,pop_asian,18,24,6,22,19
0014,pop_black,1736,1853,117,1806,1759
0014,pop_hisp,73,86,13,81,76
0014,pop_nhpi,0,0,0,0,0
0014,pop_other,0,0,0,0,0
0014,pop_two,79,67,-12,72,77
0014,pop_white,380,183,-197,262,341
0014,vap,1651,1591,-60,1615,1639
0014,vap_aian,2,1,-1,1,2
0014,vap_asian,15,17,2,16,15
0014,vap_black,1200,1305,105,1263,1221
0014,vap_hisp,44,55,11,51,46
0014,vap_nhpi,0,0,0,0,0
0014,vap_other,0,0,0,0,0
0014,vap_two,32,42,10,38,34
0014,vap_white,358,171,-187,246,321
0015,pop,1285,1340,55,1318,1296
0015,pop_aian,16,5,-11,9,14
0015,pop_asian,71,198,127,147,96
0015,pop_black,380,399,19,391,384
0015,pop_hisp,34,144,110,100,56
0015,pop_nhpi,0,3,3,2,1
0015,pop_other,1,7,6,5,2
0015,pop_two,26,62,36,48,33
0015,pop_white,757,522,-235,616,710
0015,vap,988,1015,27,1004,993
0015,vap_aian,11,5,-6,7,10
0015,vap_asian,37,110,73,81,52
0015,vap_black,284,329,45,311,293
0015,vap_hisp,26,87,61,63,38
0015,vap_nhpi,0,3,3,2,1
0015,vap_other,1,7,6,5,2
0015,vap_two,10,38,28,27,16
0015,vap_white,619,436,-183,509,582
0016,pop,3305,3077,-228,3168,3259
0016,pop_aian,18,9,-9,13,16
0016,pop_asian,168,257,89,221,186
0016,pop_black,2224,2126,-98,2165,2204
0016,pop_hisp,119,140,21,132,123
0016,pop_nhpi,0,0,0,0,0
0016,pop_other,8,7,-1,7,8
0016,pop_two,133,119,-14,125,130
0016,pop_white,635,419,-216,505,592
0016,vap,2313,2234,-79,2266,2297
0016,vap_aian,13,3,-10,7,11
0016,vap_asian,90,164,74,134,105
0016,vap_black,1505,1506,1,1506,1505
0016,vap_hisp,69,103,34,89,76
0016,vap_nhpi,0,0,0,0,0
0016,vap_other,5,7,2,6,5
0016,vap_two,49,63,14,57,52
0016,vap_white,582,388,-194,466,543
0017,pop,1268,1249,-19,1257,1264
0017,pop_aian,2,2,0,2,2
0017,pop_asian,64,73,9,69,66
0017,pop_black,663,655,-8,658,661
0017,pop_hisp,68,106,38,91,76
0017,pop_nhpi,0,1,1,1,0
0017,pop_other,9,9,0,9,9
0017,pop_two,39,116,77,85,54
0017,pop_white,423,287,-136,341,396
0017,vap,909,928,19,920,913
0017,vap_aian,2,0,-2,1,2
0017,vap_asian,44,41,-3,42,43
0017,vap_black,435,480,45,462,444
0017,vap_hisp,37,60,23,51,42
0017,vap_nhpi,0,1,1,1,0
0017,vap_other,2,7,5,5,3
0017,vap_two,24,80,56,58,35
0017,vap_white,365,259,-106,301,344
0018,pop,2070,1889,-181,1961,2034
0018,pop_aian,7,1,-6,3,6
0018,pop_asian,40,129,89,93,58
0018,pop_black,1432,1188,-244,1286,1383
0018,pop_hisp,73,116,43,99,82
0018,pop_nhpi,0,0,0,0,0
0018,pop_other,0,6,6,4,1
0018,pop_two,43,87,44,69,52
0018,pop_white,475,362,-113,407,452
0018,vap,1388,1357,-31,1369,1382
0018,vap_aian,4,1,-3,2,3
0018,vap_asian,29,77,48,58,39
0018,vap_black,886,824,-62,849,874
0018,vap_hisp,41,80,39,64,49
0018,vap_nhpi,0,0,0,0,0
0018,vap_other,0,4,4,2,1
0018,vap_two,23,48,25,38,28
0018,vap_white,405,323,-82,356,389
0019,pop,1954,2016,62,1991,1966
0019,pop_aian,8,9,1,9,8
0019,pop_asian,20,133,113,88,43
0019,pop_black,1517,1474,-43,1491,1508
0019,pop_hisp,57,99,42,82,65
0019,pop_nhpi,2,2,0,2,2
0019,pop_other,0,7,7,4,1
0019,pop_two,53,80,27,69,58
0019,pop_white,297,212,-85,246,280
0019,vap,1119,1202,83,1169,1136
0019,vap_aian,5,4,-1,4,5
0019,vap_asian,14,85,71,57,28
0019,vap_black,794,826,32,813,800
0019,vap_hisp,22,56,34,42,29
0019,vap_nhpi,2,2,0,2,2
0019,vap_other,0,2,2,1,0
0019,vap_two,24,38,14,32,27
0019,vap_white,258,189,-69,217,244
0020,pop,2215,1977,-238,2072,2167
0020,pop_aian,13,3,-10,7,11
0020,pop_asian,26,30,4,28,27
0020,pop_black,1650,1522,-128,1573,1624
0020,pop_hisp,93,110,17,103,96
0020,pop_nhpi,0,0,0,0,0
0020,pop_other,2,11,9,7,4
0020,pop_two,51,75,24,65,56
0020,pop_white,380,226,-154,288,349
0020,vap,1501,1422,-79,1454,1485
0020,vap_aian,7,3,-4,5,6
0020,vap_asian,15,24,9,20,17
0020,vap_black,1079,1053,-26,1063,1074
0020,vap_hisp,52,86,34,72,59
0020,vap_nhpi,0,0,0,0,0
0020,vap_other,2,11,9,7,4
0020,vap_two,17,47,30,35,23
0020,vap_white,329,198,-131,250,303
0021,pop,2060,1954,-106,1996,2039
0021,pop_aian,10,5,-5,7,9
0021,pop_asian,5,32,27,21,10
0021,pop_black,1761,1677,-84,1711,1744
0021,pop_hisp,49,54,5,52,50
0021,pop_nhpi,0,0,0,0,0
0021,pop_other,2,9,7,6,3
0021,pop_two,42,65,23,56,47
0021,pop_white,191,112,-79,144,175
0021,vap,1327,1296,-31,1308,1321
0021,vap_aian,5,5,0,5,5
0021,vap_asian,5,26,21,18,9
0021,vap_black,1091,1091,0,1091,1091
0021,vap_hisp,28,32,4,30,29
0021,vap_nhpi,0,0,0,0,0
0021,vap_other,0,5,5,3,1
0021,vap_two,19,34,15,28,22
0021,vap_white,179,103,-76,133,164
0022,pop,2007,1857,-150,1917,1977
0022,pop_aian,12,4,-8,7,10
0022,pop_asian,36,31,-5,33,35
0022,pop_black,1508,1453,-55,1475,1497
0022,pop_hisp,69,86,17,79,72
0022,pop_nhpi,0,0,0,0,0
0022,pop_other,2,5,3,4,3
0022,pop_two,75,73,-2,74,75
0022,pop_white,305,205,-100,245,285
0022,vap,1317,1287,-30,1299,1311
0022,vap_aian,10,4,-6,6,9
0022,vap_asian,19,26,7,23,20
0022,vap_black,932,972,40,956,940
0022,vap_hisp,42,59,17,52,45
0022,vap_nhpi,0,0,0,0,0
0022,vap_other,2,3,1,3,2
0022,vap_two,30,25,-5,27,29
0022,vap_white,282,198,-84,232,265
0023,pop,1196,1157,-39,1173,1188
0023,pop_aian,6,0,-6,2,5
0023,pop_asian,133,108,-25,118,128
0023,pop_black,843,866,23,857,848
0023,pop_hisp,38,63,25,53,43
0023,pop_nhpi,10,0,-10,4,8
0023,pop_other,0,2,2,1,0
0023,pop_two,26,30,4,28,27
0023,pop_white,140,88,-52,109,130
0023,vap,743,742,-1,742,743
0023,vap_aian,6,0,-6,2,5
0023,vap_asian,69,70,1,70,69
0023,vap_black,505,531,26,521,510
0023,vap_hisp,24,37,13,32,27
0023,vap_nhpi,2,0,-2,1,2
0023,vap_other,0,2,2,1,0
0023,vap_two,13,17,4,15,14
0023,vap_white,125,85,-40,101,117
0024,pop,1803,1731,-72,1760,1789
0024,pop_aian,1,4,3,3,2
0024,pop_asian,519,504,-15,510,516
0024,pop_black,1180,1096,-84,1130,1163
0024,pop_hisp,10,49,39,33,18
0024,pop_nhpi,0,0,0,0,0
0024,pop_other,1,1,0,1,1
0024,pop_two,33,44,11,40,35
0024,pop_white,59,33,-26,43,54
0024,vap,1008,1014,6,1012,1009
0024,vap_aian,1,4,3,3,2
0024,vap_asian,266,306,40,290,274
0024,vap_black,673,629,-44,647,664
0024,vap_hisp,5,20,15,14,8
0024,vap_nhpi,0,0,0,0,0
0024,vap_other,1,1,0,1,1
0024,vap_two,10,22,12,17,12
0024,vap_white,52,32,-20,40,48
0025,pop,2072,2050,-22,2059,2068
0025,pop_aian,9,11,2,10,9
0025,pop_asian,190,244,54,222,201
0025,pop_black,1444,1464,20,1456,1448
0025,pop_hisp,113,93,-20,101,109
0025,pop_nhpi,0,0,0,0,0
0025,pop_other,6,20,14,14,9
0025,pop_two,45,75,30,63,51
0025,pop_white,265,143,-122,192,241
0025,vap,1306,1323,17,1316,1309
0025,vap_aian,7,11,4,9,8
0025,vap_asian,104,147,43,130,113
0025,vap_black,880,916,36,902,887
0025,vap_hisp,55,67,12,62,57
0025,vap_nhpi,0,0,0,0,0
0025,vap_other,3,8,5,6,4
0025,vap_two,19,43,24,33,24
0025,vap_white,238,131,-107,174,217
0026,pop,1659,1634,-25,1644,1654
0026,pop_aian,1,17,16,11,4
0026,pop_asian,198,212,14,206,201
0026,pop_black,1060,1121,61,1097,1072
0026,pop_hisp,57,65,8,62,59
0026,pop_nhpi,0,0,0,0,0
0026,pop_other,0,13,13,8,3
0026,pop_two,50,66,16,60,53
0026,pop_white,292,140,-152,201,262
0026,vap,1121,1125,4,1123,1122
0026,vap_aian,1,9,8,6,3
0026,vap_asian,107,144,37,129,114
0026,vap_black,696,763,67,736,709
0026,vap_hisp,29,33,4,31,30
0026,vap_nhpi,0,0,0,0,0
0026,vap_other,0,9,9,5,2
0026,vap_two,22,34,12,29,24
0026,vap_white,266,133,-133,186,239
0027,pop,1794,1635,-159,1699,1762
0027,pop_aian,4,6,2,5,4
0027,pop_asian,494,510,16,504,497
0027,pop_black,987,857,-130,909,961
0027,pop_hisp,61,63,2,62,61
0027,pop_nhpi,0,0,0,0,0
0027,pop_other,0,5,5,3,1
0027,pop_two,34,36,2,35,34
0027,pop_white,214,158,-56,180,203
0027,vap,1176,1097,-79,1129,1160
0027,vap_aian,2,5,3,4,3
0027,vap_asian,260,321,61,297,272
0027,vap_black,666,583,-83,616,649
0027,vap_hisp,37,36,-1,36,37
0027,vap_nhpi,0,0,0,0,0
0027,vap_other,0,4,4,2,1
0027,vap_two,18,10,-8,13,16
0027,vap_white,193,138,-55,160,182
0028,pop,1081,900,-181,972,1045
0028,pop_aian,3,2,-1,2,3
0028,pop_asian,468,267,-201,347,428
0028,pop_black,470,530,60,506,482
0028,pop_hisp,40,18,-22,27,36
0028,pop_nhpi,0,0,0,0,0
0028,pop_other,0,3,3,2,1
0028,pop_two,25,23,-2,24,25
0028,pop_white,75,57,-18,64,71
0028,vap,613,558,-55,580,602
0028,vap_aian,2,2,0,2,2
0028,vap_asian,243,168,-75,198,228
0028,vap_black,272,322,50,302,282
0028,vap_hisp,22,14,-8,17,20
0028,vap_nhpi,0,0,0,0,0
0028,vap_other,0,0,0,0,0
0028,vap_two,11,3,-8,6,9
0028,vap_white,63,49,-14,55,60
0029,pop,1163,1046,-117,1093,1140
0029,pop_aian,0,1,1,1,0
0029,pop_asian,68,57,-11,61,66
0029,pop_black,828,803,-25,813,823
0029,pop_hisp,24,39,15,33,27
0029,pop_nhpi,0,0,0,0,0
0029,pop_other,0,1,1,1,0
0029,pop_two,62,57,-5,59,61
0029,pop_white,181,88,-93,125,162
0029,vap,756,686,-70,714,742
0029,vap_aian,0,1,1,1,0
0029,vap_asian,32,36,4,34,33
0029,vap_black,530,505,-25,515,525
0029,vap_hisp,12,24,12,19,14
0029,vap_nhpi,0,0,0,0,0
0029,vap_other,0,0,0,0,0
0029,vap_two,20,36,16,30,23
0029,vap_white,162,84,-78,115,146
0030,pop,1730,1875,145,1817,1759
0030,pop_aian,6,6,0,6,6
0030,pop_asian,191,320,129,268,217
0030,pop_black,1089,1171,82,1138,1105
0030,pop_hisp,67,60,-7,63,66
0030,pop_nhpi,0,2,2,1,0
0030,pop_other,0,3,3,2,1
0030,pop_two,25,89,64,63,38
0030,pop_white,352,224,-128,275,326
0030,vap,1146,1246,100,1206,1166
0030,vap_aian,5,6,1,6,5
0030,vap_asian,110,192,82,159,126
0030,vap_black,685,755,70,727,699
0030,vap_hisp,37,31,-6,33,36
0030,vap_nhpi,0,2,2,1,0
0030,vap_other,0,3,3,2,1
0030,vap_two,12,40,28,29,18
0030,vap_white,297,217,-80,249,281
0031,pop,2115,2136,21,2128,2119
0031,pop_aian,7,9,2,8,7
0031,pop_asian,99,202,103,161,120
0031,pop_black,1553,1496,-57,1519,1542
0031,pop_hisp,80,127,47,108,89
0031,pop_nhpi,0,0,0,0,0
0031,pop_other,1,6,5,4,2
0031,pop_two,68,97,29,85,74
0031,pop_white,307,199,-108,242,285
0031,vap,1244,1321,77,1290,1259
0031,vap_aian,6,9,3,8,7
0031,vap_asian,54,130,76,100,69
0031,vap_black,862,892,30,880,868
0031,vap_hisp,42,75,33,62,49
0031,vap_nhpi,0,0,0,0,0
0031,vap_other,1,4,3,3,2
0031,vap_two,24,41,17,34,27
0031,vap_white,255,170,-85,204,238
0032,pop,3905,3757,-148,3816,3875
0032,pop_aian,5,11,6,9,6
0032,pop_asian,182,379,197,300,221
0032,pop_black,2601,2375,-226,2465,2556
0032,pop_hisp,154,256,102,215,174
0032,pop_nhpi,2,1,-1,1,2
0032,pop_other,2,25,23,16,7
0032,pop_two,139,153,14,147,142
0032,pop_white,820,557,-263,662,767
0032,vap,2555,2485,-70,2513,2541
0032,vap_aian,4,10,6,8,5
0032,vap_asian,116,245,129,193,142
0032,vap_black,1563,1512,-51,1532,1553
0032,vap_hisp,87,132,45,114,96
0032,vap_nhpi,2,1,-1,1,2
0032,vap_other,1,13,12,8,3
0032,vap_two,41,74,33,61,48
0032,vap_white,741,498,-243,595,692
0033,pop,3844,3535,-309,3659,3782
0033,pop_aian,16,16,0,16,16
0033,pop_asian,106,190,84,156,123
0033,pop_black,1085,1222,137,1167,1112
0033,pop_hisp,157,250,93,213,176
0033,pop_nhpi,4,0,-4,2,3
0033,pop_other,6,14,8,11,8
0033,pop_two,130,170,40,154,138
0033,pop_white,2340,1673,-667,1940,2207
0033,vap,2795,2683,-112,2728,2773
0033,vap_aian,11,12,1,12,11
0033,vap_asian,70,118,48,99,80
0033,vap_black,713,888,175,818,748
0033,vap_hisp,76,133,57,110,87
0033,vap_nhpi,2,0,-2,1,2
0033,vap_other,0,8,8,5,2
0033,vap_two,48,85,37,70,55
0033,vap_white,1875,1439,-436,1613,1788
0034,pop,2897,3000,103,2959,2918
0034,pop_aian,15,12,-3,13,14
0034,pop_asian,82,231,149,171,112
0034,pop_black,1445,1606,161,1542,1477
0034,pop_hisp,155,192,37,177,162
0034,pop_nhpi,4,1,-3,2,3
0034,pop_other,10,27,17,20,13
0034,pop_two,123,137,14,131,126
0034,pop_white,1063,794,-269,902,1009
0034,vap,2066,2165,99,2125,2086
0034,vap_aian,12,12,0,12,12
0034,vap_asian,58,161,103,120,79
0034,vap_black,939,1052,113,1007,962
0034,vap_hisp,89,122,33,109,96
0034,vap_nhpi,4,0,-4,2,3
0034,vap_other,6,22,16,16,9
0034,vap_two,48,90,42,73,56
0034,vap_white,910,706,-204,788,869
0035,pop,2013,2019,6,2017,2014
0035,pop_aian,15,7,-8,10,13
0035,pop_asian,72,186,114,140,95
0035,pop_black,719,950,231,858,765
0035,pop_hisp,137,154,17,147,140
0035,pop_nhpi,1,0,-1,0,1
0035,pop_other,1,9,8,6,3
0035,pop_two,77,87,10,83,79
0035,pop_white,991,626,-365,772,918
0035,vap,1432,1467,35,1453,1439
0035,vap_aian,10,5,-5,7,9
0035,vap_asian,55,126,71,98,69
0035,vap_black,448,632,184,558,485
0035,vap_hisp,81,100,19,92,85
0035,vap_nhpi,1,0,-1,0,1
0035,vap_other,0,9,9,5,2
0035,vap_two,26,38,12,33,28
0035,vap_white,812,557,-255,659,761
0036,pop,1748,1728,-20,1736,1744
0036,pop_aian,1,9,8,6,3
0036,pop_asian,147,122,-25,132,142
0036,pop_black,1158,1274,116,1228,1181
0036,pop_hisp,37,61,24,51,42
0036,pop_nhpi,0,2,2,1,0
0036,pop_other,4,6,2,5,4
0036,pop_two,63,57,-6,59,62
0036,pop_white,338,197,-141,253,310
0036,vap,1158,1237,79,1205,1174
0036,vap_aian,1,9,8,6,3
0036,vap_asian,87,77,-10,81,85
0036,vap_black,730,888,158,825,762
0036,vap_hisp,18,33,15,27,21
0036,vap_nhpi,0,2,2,1,0
0036,vap_other,3,2,-1,2,3
0036,vap_two,24,43,19,35,28
0036,vap_white,294,183,-111,227,272
0037,pop,2724,2220,-504,2422,2623
0037,pop_aian,21,2,-19,10,17
0037,pop_asian,79,131,52,110,89
0037,pop_black,2078,1676,-402,1837,1998
0037,pop_hisp,89,79,-10,83,87
0037,pop_nhpi,1,0,-1,0,1
0037,pop_other,0,7,7,4,1
0037,pop_two,114,69,-45,87,105
0037,pop_white,342,256,-86,290,325
0037,vap,1721,1456,-265,1562,1668
0037,vap_aian,16,2,-14,8,13
0037,vap_asian,40,89,49,69,50
0037,vap_black,1253,1064,-189,1140,1215
0037,vap_hisp,53,38,-15,44,50
0037,vap_nhpi,1,0,-1,0,1
0037,vap_other,0,7,7,4,1
0037,vap_two,35,38,3,37,36
0037,vap_white,323,218,-105,260,302
0038,pop,1517,1486,-31,1498,1511
0038,pop_aian,10,2,-8,5,8
0038,pop_asian,18,98,80,66,34
0038,pop_black,1160,1107,-53,1128,1149
0038,pop_hisp,54,90,36,76,61
0038,pop_nhpi,0,0,0,0,0
0038,pop_other,5,12,7,9,6
0038,pop_two,44,69,25,59,49
0038,pop_white,226,108,-118,155,202
0038,vap,977,986,9,982,979
0038,vap_aian,5,2,-3,3,4
0038,vap_asian,10,45,35,31,17
0038,vap_black,719,730,11,726,721
0038,vap_hisp,33,54,21,46,37
0038,vap_nhpi,0,0,0,0,0
0038,vap_other,1,8,7,5,2
0038,vap_two,15,43,28,32,21
0038,vap_white,194,104,-90,140,176
0039,pop,1590,1593,3,1592,1591
0039,pop_aian,7,6,-1,6,7
0039,pop_asian,115,179,64,153,128
0039,pop_black,847,928,81,896,863
0039,pop_hisp,46,111,65,85,59
0039,pop_nhpi,2,3,1,3,2
0039,pop_other,5,5,0,5,5
0039,pop_two,42,48,6,46,43
0039,pop_white,526,313,-213,398,483
0039,vap,1086,1075,-11,1079,1084
0039,vap_aian,5,6,1,6,5
0039,vap_asian,66,122,56,100,77
0039,vap_black,525,589,64,563,538
0039,vap_hisp,25,48,23,39,30
0039,vap_nhpi,2,3,1,3,2
0039,vap_other,2,1,-1,1,2
0039,vap_two,14,28,14,22,17
0039,vap_white,447,278,-169,346,413
0040,pop,1898,1728,-170,1796,1864
0040,pop_aian,4,0,-4,2,3
0040,pop_asian,78,82,4,80,79
0040,pop_black,1370,1374,4,1372,1371
0040,pop_hisp,79,81,2,80,79
0040,pop_nhpi,0,1,1,1,0
0040,pop_other,14,2,-12,7,12
0040,pop_two,68,40,-28,51,62
0040,pop_white,285,148,-137,203,258
0040,vap,1205,1127,-78,1158,1189
0040,vap_aian,2,0,-2,1,2
0040,vap_asian,42,59,17,52,45
0040,vap_black,846,861,15,855,849
0040,vap_hisp,42,43,1,43,42
0040,vap_nhpi,0,1,1,1,0
0040,vap_other,4,0,-4,2,3
0040,vap_two,23,32,9,28,25
0040,vap_white,246,131,-115,177,223
0041,pop,1609,1628,19,1620,1613
0041,pop_aian,1,0,-1,0,1
0041,pop_asian,48,90,42,73,56
0041,pop_black,1121,1218,97,1179,1140
0041,pop_hisp,72,88,16,82,75
0041,pop_nhpi,0,0,0,0,0
0041,pop_other,1,5,4,3,2
0041,pop_two,35,55,20,47,39
0041,pop_white,330,172,-158,235,298
0041,vap,1142,1145,3,1144,1143
0041,vap_aian,0,0,0,0,0
0041,vap_asian,32,62,30,50,38
0041,vap_black,750,825,75,795,765
0041,vap_hisp,41,60,19,52,45
0041,vap_nhpi,0,0,0,0,0
0041,vap_other,1,5,4,3,2
0041,vap_two,19,28,9,24,21
0041,vap_white,299,165,-134,219,272
0042,pop,1870,1898,28,1887,1876
0042,pop_aian,7,12,5,10,8
0042,pop_asian,110,141,31,129,116
0042,pop_black,1256,1387,131,1335,1282
0042,pop_hisp,82,88,6,86,83
0042,pop_nhpi,0,0,0,0,0
0042,pop_other,2,10,8,7,4
0042,pop_two,42,62,20,54,46
0042,pop_white,371,198,-173,267,336
0042,vap,1340,1343,3,1342,1341
0042,vap_aian,7,4,-3,5,6
0042,vap_asian,64,100,36,86,71
0042,vap_black,859,960,101,920,879
0042,vap_hisp,50,48,-2,49,50
0042,vap_nhpi,0,0,0,0,0
0042,vap_other,2,8,6,6,3
0042,vap_two,20,43,23,34,25
0042,vap_white,338,180,-158,243,306
0043,pop,1552,628,-924,998,1367
0043,pop_aian,7,2,-5,4,6
0043,pop_asian,33,67,34,53,40
0043,pop_black,1350,434,-916,800,1167
0043,pop_hisp,31,37,6,35,32
0043,pop_nhpi,0,0,0,0,0
0043,pop_other,0,0,0,0,0
0043,pop_two,23,11,-12,16,21
0043,pop_white,108,77,-31,89,102
0043,vap,849,452,-397,611,770
0043,vap_aian,3,2,-1,2,3
0043,vap_asian,19,41,22,32,23
0043,vap_black,700,306,-394,464,621
0043,vap_hisp,17,23,6,21,18
0043,vap_nhpi,0,0,0,0,0
0043,vap_other,0,0,0,0,0
0043,vap_two,10,6,-4,8,9
0043,vap_white,100,74,-26,84,95
0044,pop,1912,1814,-98,1853,1892
0044,pop_aian,9,3,-6,5,8
0044,pop_asian,84,65,-19,73,80
0044,pop_black,1370,1348,-22,1357,1366
0044,pop_hisp,86,124,38,109,94
0044,pop_nhpi,0,0,0,0,0
0044,pop_other,0,14,14,8,3
0044,pop_two,47,58,11,54,49
0044,pop_white,316,202,-114,248,293
0044,vap,1301,1328,27,1317,1306
0044,vap_aian,5,3,-2,4,5
0044,vap_asian,52,40,-12,45,50
0044,vap_black,880,989,109,945,902
0044,vap_hisp,56,70,14,64,59
0044,vap_nhpi,0,0,0,0,0
0044,vap_other,0,4,4,2,1
0044,vap_two,20,33,13,28,23
0044,vap_white,288,189,-99,229,268
0045,pop,2481,2249,-232,2342,2435
0045,pop_aian,11,6,-5,8,10
0045,pop_asian,151,136,-15,142,148
0045,pop_black,1886,1762,-124,1812,1861
0045,pop_hisp,82,79,-3,80,81
0045,pop_nhpi,0,1,1,1,0
0045,pop_other,5,20,15,14,8
0045,pop_two,61,61,0,61,61
0045,pop_white,285,184,-101,224,265
0045,vap,1563,1459,-104,1501,1542
0045,vap_aian,11,6,-5,8,10
0045,vap_asian,92,88,-4,90,91
0045,vap_black,1121,1090,-31,1102,1115
0045,vap_hisp,50,61,11,57,52
0045,vap_nhpi,0,1,1,1,0
0045,vap_other,3,15,12,10,5
0045,vap_two,27,25,-2,26,27
0045,vap_white,259,173,-86,207,242
0046,pop,1234,1141,-93,1178,1215
0046,pop_aian,6,1,-5,3,5
0046,pop_asian,49,65,16,59,52
0046,pop_black,972,925,-47,944,963
0046,pop_hisp,70,38,-32,51,64
0046,pop_nhpi,0,0,0,0,0
0046,pop_other,4,1,-3,2,3
0046,pop_two,22,45,23,36,27
0046,pop_white,111,66,-45,84,102
0046,vap,794,780,-14,786,791
0046,vap_aian,3,1,-2,2,3
0046,vap_asian,27,45,18,38,31
0046,vap_black,601,613,12,608,603
0046,vap_hisp,43,28,-15,34,40
0046,vap_nhpi,0,0,0,0,0
0046,vap_other,1,0,-1,0,1
0046,vap_two,13,31,18,24,17
0046,vap_white,106,62,-44,80,97
0047,pop,2326,2308,-18,2315,2322
0047,pop_aian,5,12,7,9,6
0047,pop_asian,94,151,57,128,105
0047,pop_black,1786,1760,-26,1770,1781
0047,pop_hisp,97,102,5,100,98
0047,pop_nhpi,1,0,-1,0,1
0047,pop_other,6,11,5,9,7
0047,pop_two,67,82,15,76,70
0047,pop_white,270,190,-80,222,254
0047,vap,1549,1553,4,1551,1550
0047,vap_aian,4,3,-1,3,4
0047,vap_asian,42,79,37,64,49
0047,vap_black,1166,1177,11,1173,1168
0047,vap_hisp,58,64,6,62,59
0047,vap_nhpi,1,0,-1,0,1
0047,vap_other,3,7,4,5,4
0047,vap_two,33,47,14,41,36
0047,vap_white,242,176,-66,202,229
0048,pop,1030,1011,-19,1019,1026
0048,pop_aian,3,2,-1,2,3
0048,pop_asian,45,31,-14,37,42
0048,pop_black,720,761,41,745,728
0048,pop_hisp,39,57,18,50,43
0048,pop_nhpi,0,0,0,0,0
0048,pop_other,1,2,1,2,1
0048,pop_two,24,17,-7,20,23
0048,pop_white,198,141,-57,164,187
0048,vap,740,744,4,742,741
0048,vap_aian,3,2,-1,2,3
0048,vap_asian,31,23,-8,26,29
0048,vap_black,489,529,40,513,497
0048,vap_hisp,24,43,19,35,28
0048,vap_nhpi,0,0,0,0,0
0048,vap_other,0,0,0,0,0
0048,vap_two,10,12,2,11,10
0048,vap_white,183,135,-48,154,173
0049,pop,1364,1355,-9,1359,1362
0049,pop_aian,6,2,-4,4,5
0049,pop_asian,1,12,11,8,3
0049,pop_black,1102,1078,-24,1088,1097
0049,pop_hisp,66,93,27,82,71
0049,pop_nhpi,0,1,1,1,0
0049,pop_other,0,10,10,6,2
0049,pop_two,35,66,31,54,41
0049,pop_white,154,93,-61,117,142
0049,vap,914,945,31,933,920
0049,vap_aian,4,2,-2,3,4
0049,vap_asian,1,10,9,6,3
0049,vap_black,713,759,46,741,722
0049,vap_hisp,38,49,11,45,40
0049,vap_nhpi,0,1,1,1,0
0049,vap_other,0,6,6,4,1
0049,vap_two,18,33,15,27,21
0049,vap_white,140,85,-55,107,129
0050,pop,1351,1288,-63,1313,1338
0050,pop_aian,9,4,-5,6,8
0050,pop_asian,19,42,23,33,24
0050,pop_black,1158,1072,-86,1106,1141
0050,pop_hisp,46,64,18,57,50
0050,pop_nhpi,1,1,0,1,1
0050,pop_other,4,2,-2,3,4
0050,pop_two,8,54,46,36,17
0050,pop_white,106,49,-57,72,95
0050,vap,903,862,-41,878,895
0050,vap_aian,6,4,-2,5,6
0050,vap_asian,12,27,15,21,15
0050,vap_black,750,709,-41,725,742
0050,vap_hisp,31,46,15,40,34
0050,vap_nhpi,1,0,-1,0,1
0050,vap_other,1,1,0,1,1
0050,vap_two,5,30,25,20,10
0050,vap_white,97,45,-52,66,87
0051,pop,1657,1513,-144,1571,1628
0051,pop_aian,8,15,7,12,9
0051,pop_asian,1,10,9,6,3
0051,pop_black,1476,1269,-207,1352,1435
0051,pop_hisp,64,72,8,69,66
0051,pop_nhpi,6,1,-5,3,5
0051,pop_other,0,17,17,10,3
0051,pop_two,29,50,21,42,33
0051,pop_white,73,79,6,77,74
0051,vap,1063,1033,-30,1045,1057
0051,vap_aian,4,8,4,6,5
0051,vap_asian,0,9,9,5,2
0051,vap_black,945,870,-75,900,930
0051,vap_hisp,31,46,15,40,34
0051,vap_nhpi,4,0,-4,2,3
0051,vap_other,0,7,7,4,1
0051,vap_two,12,25,13,20,15
0051,vap_white,67,68,1,68,67
0052,pop,2089,1820,-269,1928,2035
0052,pop_aian,12,1,-11,5,10
0052,pop_asian,1,13,12,8,3
0052,pop_black,1755,1567,-188,1642,1717
0052,pop_hisp,69,67,-2,68,69
0052,pop_nhpi,1,0,-1,0,1
0052,pop_other,5,12,7,9,6
0052,pop_two,40,54,14,48,43
0052,pop_white,206,106,-100,146,186
0052,vap,1440,1292,-148,1351,1410
0052,vap_aian,9,1,-8,4,7
0052,vap_asian,1,11,10,7,3
0052,vap_black,1182,1096,-86,1130,1165
0052,vap_hisp,44,44,0,44,44
0052,vap_nhpi,1,0,-1,0,1
0052,vap_other,3,10,7,7,4
0052,vap_two,19,35,16,29,22
0052,vap_white,181,95,-86,129,164
0053,pop,992,883,-109,927,970
0053,pop_aian,2,0,-2,1,2
0053,pop_asian,2,6,4,4,3
0053,pop_black,825,746,-79,778,809
0053,pop_hisp,45,46,1,46,45
0053,pop_nhpi,0,0,0,0,0
0053,pop_other,0,0,0,0,0
0053,pop_two,23,33,10,29,25
0053,pop_white,95,52,-43,69,86
0053,vap,714,636,-78,667,698
0053,vap_aian,2,0,-2,1,2
0053,vap_asian,2,6,4,4,3
0053,vap_black,585,537,-48,556,575
0053,vap_hisp,23,26,3,25,24
0053,vap_nhpi,0,0,0,0,0
0053,vap_other,0,0,0,0,0
0053,vap_two,14,22,8,19,16
0053,vap_white,88,45,-43,62,79
0054,pop,1047,1051,4,1049,1048
0054,pop_aian,0,2,2,1,0
0054,pop_asian,18,20,2,19,18
0054,pop_black,928,882,-46,900,919
0054,pop_hisp,26,33,7,30,27
0054,pop_nhpi,0,0,0,0,0
0054,pop_other,0,9,9,5,2
0054,pop_two,11,57,46,39,20
0054,pop_white,64,48,-16,54,61
0054,vap,732,783,51,763,742
0054,vap_aian,0,2,2,1,0
0054,vap_asian,8,13,5,11,9
0054,vap_black,639,668,29,656,645
0054,vap_hisp,18,18,0,18,18
0054,vap_nhpi,0,0,0,0,0
0054,vap_other,0,9,9,5,2
0054,vap_two,6,36,30,24,12
0054,vap_white,61,37,-24,47,56
0055,pop,2409,2439,30,2427,2415
0055,pop_aian,7,3,-4,5,6
0055,pop_asian,33,62,29,50,39
0055,pop_black,1521,1514,-7,1517,1520
0055,pop_hisp,115,184,69,156,129
0055,pop_nhpi,0,0,0,0,0
0055,pop_other,1,9,8,6,3
0055,pop_two,72,108,36,94,79
0055,pop_white,660,559,-101,599,640
0055,vap,1716,1767,51,1747,1726
0055,vap_aian,7,1,-6,3,6
0055,vap_asian,22,38,16,32,25
0055,vap_black,1030,1047,17,1040,1033
0055,vap_hisp,71,120,49,100,81
0055,vap_nhpi,0,0,0,0,0
0055,vap_other,1,9,8,6,3
0055,vap_two,31,59,28,48,37
0055,vap_white,554,493,-61,517,542
0056,pop,1427,1236,-191,1312,1389
0056,pop_aian,2,4,2,3,2
0056,pop_asian,1,2,1,2,1
0056,pop_black,1320,1130,-190,1206,1282
0056,pop_hisp,29,47,18,40,33
0056,pop_nhpi,0,0,0,0,0
0056,pop_other,1,3,2,2,1
0056,pop_two,34,14,-20,22,30
0056,pop_white,40,36,-4,38,39
0056,vap,963,892,-71,920,949
0056,vap_aian,2,1,-1,1,2
0056,vap_asian,1,2,1,2,1
0056,vap_black,887,835,-52,856,877
0056,vap_hisp,18,18,0,18,18
0056,vap_nhpi,0,0,0,0,0
0056,vap_other,1,1,0,1,1
0056,vap_two,19,9,-10,13,17
0056,vap_white,35,26,-9,30,33
0057,pop,1957,1756,-201,1836,1917
0057,pop_aian,4,14,10,10,6
0057,pop_asian,2,6,4,4,3
0057,pop_black,1777,1568,-209,1652,1735
0057,pop_hisp,67,80,13,75,70
0057,pop_nhpi,1,0,-1,0,1
0057,pop_other,0,6,6,4,1
0057,pop_two,44,31,-13,36,41
0057,pop_white,62,51,-11,55,60
0057,vap,1372,1293,-79,1325,1356
0057,vap_aian,4,11,7,8,5
0057,vap_asian,2,6,4,4,3
0057,vap_black,1255,1156,-99,1196,1235
0057,vap_hisp,34,51,17,44,37
0057,vap_nhpi,1,0,-1,0,1
0057,vap_other,0,2,2,1,0
0057,vap_two,16,18,2,17,16
0057,vap_white,60,49,-11,53,58
0058,pop,1373,1234,-139,1290,1345
0058,pop_aian,2,2,0,2,2
0058,pop_asian,5,3,-2,4,5
0058,pop_black,1244,1077,-167,1144,1211
0058,pop_hisp,36,65,29,53,42
0058,pop_nhpi,0,0,0,0,0
0058,pop_other,3,5,2,4,3
0058,pop_two,20,49,29,37,26
0058,pop_white,63,33,-30,45,57
0058,vap,989,916,-73,945,974
0058,vap_aian,1,2,1,2,1
0058,vap_asian,4,3,-1,3,4
0058,vap_black,894,812,-82,845,878
0058,vap_hisp,22,37,15,31,25
0058,vap_nhpi,0,0,0,0,0
0058,vap_other,1,4,3,3,2
0058,vap_two,12,29,17,22,15
0058,vap_white,55,29,-26,39,50
0059,pop,2412,2311,-101,2351,2392
0059,pop_aian,3,5,2,4,3
0059,pop_asian,1,5,4,3,2
0059,pop_black,2272,2061,-211,2145,2230
0059,pop_hisp,67,96,29,84,73
0059,pop_nhpi,0,0,0,0,0
0059,pop_other,1,1,0,1,1
0059,pop_two,25,74,49,54,35
0059,pop_white,43,69,26,59,48
0059,vap,1794,1715,-79,1747,1778
0059,vap_aian,2,5,3,4,3
0059,vap_asian,1,3,2,2,1
0059,vap_black,1708,1535,-173,1604,1673
0059,vap_hisp,35,73,38,58,43
0059,vap_nhpi,0,0,0,0,0
0059,vap_other,1,0,-1,0,1
0059,vap_two,9,46,37,31,16
0059,vap_white,38,53,15,47,41
0060,pop,1908,1608,-300,1728,1848
0060,pop_aian,4,0,-4,2,3
0060,pop_asian,3,3,0,3,3
0060,pop_black,1773,1452,-321,1580,1709
0060,pop_hisp,43,37,-6,39,42
0060,pop_nhpi,0,0,0,0,0
0060,pop_other,1,8,7,5,2
0060,pop_two,44,69,25,59,49
0060,pop_white,40,39,-1,39,40
0060,vap,1363,1161,-202,1242,1323
0060,vap_aian,3,0,-3,1,2
0060,vap_asian,3,3,0,3,3
0060,vap_black,1278,1045,-233,1138,1231
0060,vap_hisp,19,25,6,23,20
0060,vap_nhpi,0,0,0,0,0
0060,vap_other,0,8,8,5,2
0060,vap_two,23,49,26,39,28
0060,vap_white,37,31,-6,33,36
0061,pop,1656,1589,-67,1616,1643
0061,pop_aian,5,4,-1,4,5
0061,pop_asian,0,4,4,2,1
0061,pop_black,1553,1420,-133,1473,1526
0061,pop_hisp,41,56,15,50,44
0061,pop_nhpi,0,0,0,0,0
0061,pop_other,1,8,7,5,2
0061,pop_two,20,61,41,45,28
0061,pop_white,36,36,0,36,36
0061,vap,1165,1139,-26,1149,1160
0061,vap_aian,3,4,1,4,3
0061,vap_asian,0,3,3,2,1
0061,vap_black,1096,1024,-72,1053,1082
0061,vap_hisp,21,31,10,27,23
0061,vap_nhpi,0,0,0,0,0
0061,vap_other,1,8,7,5,2
0061,vap_two,13,38,25,28,18
0061,vap_white,31,31,0,31,31
0062,pop,1638,1330,-308,1453,1576
0062,pop_aian,4,3,-1,3,4
0062,pop_asian,1,10,9,6,3
0062,pop_black,1496,1213,-283,1326,1439
0062,pop_hisp,35,45,10,41,37
0062,pop_nhpi,0,0,0,0,0
0062,pop_other,2,7,5,5,3
0062,pop_two,55,26,-29,38,49
0062,pop_white,45,26,-19,34,41
0062,vap,1113,978,-135,1032,1086
0062,vap_aian,2,2,0,2,2
0062,vap_asian,1,10,9,6,3
0062,vap_black,1031,886,-145,944,1002
0062,vap_hisp,18,24,6,22,19
0062,vap_nhpi,0,0,0,0,0
0062,vap_other,0,6,6,4,1
0062,vap_two,19,25,6,23,20
0062,vap_white,42,25,-17,32,39
0063,pop,1560,1475,-85,1509,1543
0063,pop_aian,1,1,0,1,1
0063,pop_asian,11,1,-10,5,9
0063,pop_black,1464,1350,-114,1396,1441
0063,pop_hisp,29,54,25,44,34
0063,pop_nhpi,0,0,0,0,0
0063,pop_other,2,9,7,6,3
0063,pop_two,22,29,7,26,23
0063,pop_white,31,31,0,31,31
0063,vap,1051,1039,-12,1044,1049
0063,vap_aian,0,0,0,0,0
0063,vap_asian,10,1,-9,5,8
0063,vap_black,987,952,-35,966,980
0063,vap_hisp,15,32,17,25,18
0063,vap_nhpi,0,0,0,0,0
0063,vap_other,2,9,7,6,3
0063,vap_two,11,17,6,15,12
0063,vap_white,26,28,2,27,26
0064,pop,3101,2887,-214,2973,3058
0064,pop_aian,16,7,-9,11,14
0064,pop_asian,22,12,-10,16,20
0064,pop_black,2720,2510,-210,2594,2678
0064,pop_hisp,85,171,86,137,102
0064,pop_nhpi,0,0,0,0,0
0064,pop_other,6,4,-2,5,6
0064,pop_two,78,93,15,87,81
0064,pop_white,174,90,-84,124,157
0064,vap,2005,1982,-23,1991,2000
0064,vap_aian,7,5,-2,6,7
0064,vap_asian,14,12,-2,13,14
0064,vap_black,1743,1711,-32,1724,1737
0064,vap_hisp,49,107,58,84,61
0064,vap_nhpi,0,0,0,0,0
0064,vap_other,1,3,2,2,1
0064,vap_two,29,58,29,46,35
0064,vap_white,162,86,-76,116,147
0065,pop,2091,2096,5,2094,2092
0065,pop_aian,4,7,3,6,5
0065,pop_asian,15,28,13,23,18
0065,pop_black,1893,1783,-110,1827,1871
0065,pop_hisp,47,118,71,90,61
0065,pop_nhpi,0,0,0,0,0
0065,pop_other,5,2,-3,3,4
0065,pop_two,27,91,64,65,40
0065,pop_white,100,67,-33,80,93
0065,vap,1431,1469,38,1454,1439
0065,vap_aian,4,6,2,5,4
0065,vap_asian,9,16,7,13,10
0065,vap_black,1287,1249,-38,1264,1279
0065,vap_hisp,30,78,48,59,40
0065,vap_nhpi,0,0,0,0,0
0065,vap_other,0,2,2,1,0
0065,vap_two,12,57,45,39,21
0065,vap_white,89,61,-28,72,83
0066,pop,1521,1421,-100,1461,1501
0066,pop_aian,3,0,-3,1,2
0066,pop_asian,3,13,10,9,5
0066,pop_black,1422,1320,-102,1361,1402
0066,pop_hisp,23,22,-1,22,23
0066,pop_nhpi,0,0,0,0,0
0066,pop_other,0,9,9,5,2
0066,pop_two,40,22,-18,29,36
0066,pop_white,30,35,5,33,31
0066,vap,904,860,-44,878,895
0066,vap_aian,2,0,-2,1,2
0066,vap_asian,3,10,7,7,4
0066,vap_black,845,779,-66,805,832
0066,vap_hisp,11,8,-3,9,10
0066,vap_nhpi,0,0,0,0,0
0066,vap_other,0,9,9,5,2
0066,vap_two,15,19,4,17,16
0066,vap_white,28,35,7,32,29
0067,pop,1397,1396,-1,1396,1397
0067,pop_aian,6,10,4,8,7
0067,pop_asian,21,36,15,30,24
0067,pop_black,1177,1134,-43,1151,1168
0067,pop_hisp,44,78,34,64,51
0067,pop_nhpi,1,0,-1,0,1
0067,pop_other,3,5,2,4,3
0067,pop_two,24,63,39,47,32
0067,pop_white,121,70,-51,90,111
0067,vap,925,922,-3,923,924
0067,vap_aian,1,8,7,5,2
0067,vap_asian,10,11,1,11,10
0067,vap_black,763,757,-6,759,762
0067,vap_hisp,25,49,24,39,30
0067,vap_nhpi,1,0,-1,0,1
0067,vap_other,0,5,5,3,1
0067,vap_two,9,32,23,23,14
0067,vap_white,116,60,-56,82,105
0068,pop,2369,2276,-93,2313,2350
0068,pop_aian,14,0,-14,6,11
0068,pop_asian,153,212,59,188,165
0068,pop_black,1804,1728,-76,1758,1789
0068,pop_hisp,96,94,-2,95,96
0068,pop_nhpi,0,2,2,1,0
0068,pop_other,0,12,12,7,2
0068,pop_two,49,68,19,60,53
0068,pop_white,253,160,-93,197,234
0068,vap,1619,1623,4,1621,1620
0068,vap_aian,11,0,-11,4,9
0068,vap_asian,99,143,44,125,108
0068,vap_black,1187,1226,39,1210,1195
0068,vap_hisp,66,65,-1,65,66
0068,vap_nhpi,0,2,2,1,0
0068,vap_other,0,6,6,4,1
0068,vap_two,20,31,11,27,22
0068,vap_white,236,150,-86,184,219
0069,pop,1884,1710,-174,1780,1849
0069,pop_aian,7,5,-2,6,7
0069,pop_asian,18,41,23,32,23
0069,pop_black,1555,1473,-82,1506,1539
0069,pop_hisp,61,49,-12,54,59
0069,pop_nhpi,0,0,0,0,0
0069,pop_other,2,9,7,6,3
0069,pop_two,45,39,-6,41,44
0069,pop_white,195,94,-101,134,175
0069,vap,1300,1214,-86,1248,1283
0069,vap_aian,4,3,-1,3,4
0069,vap_asian,17,20,3,19,18
0069,vap_black,1050,1036,-14,1042,1047
0069,vap_hisp,31,33,2,32,31
0069,vap_nhpi,0,0,0,0,0
0069,vap_other,2,4,2,3,2
0069,vap_two,22,25,3,24,23
0069,vap_white,174,93,-81,125,158
0070,pop,2376,2195,-181,2267,2340
0070,pop_aian,1,5,4,3,2
0070,pop_asian,67,98,31,86,73
0070,pop_black,1859,1793,-66,1819,1846
0070,pop_hisp,122,89,-33,102,115
0070,pop_nhpi,0,0,0,0,0
0070,pop_other,5,2,-3,3,4
0070,pop_two,76,51,-25,61,71
0070,pop_white,246,157,-89,193,228
0070,vap,1640,1605,-35,1619,1633
0070,vap_aian,1,5,4,3,2
0070,vap_asian,47,54,7,51,48
0070,vap_black,1262,1314,52,1293,1272
0070,vap_hisp,66,57,-9,61,64
0070,vap_nhpi,0,0,0,0,0
0070,vap_other,4,2,-2,3,4
0070,vap_two,36,29,-7,32,35
0070,vap_white,224,144,-80,176,208
0071,pop,1408,1346,-62,1371,1396
0071,pop_aian,6,0,-6,2,5
0071,pop_asian,129,101,-28,112,123
0071,pop_black,1040,1054,14,1048,1043
0071,pop_hisp,37,35,-2,36,37
0071,pop_nhpi,0,0,0,0,0
0071,pop_other,2,12,10,8,4
0071,pop_two,33,34,1,34,33
0071,pop_white,161,110,-51,130,151
0071,vap,963,987,24,977,968
0071,vap_aian,4,0,-4,2,3
0071,vap_asian,78,66,-12,71,76
0071,vap_black,704,761,57,738,715
0071,vap_hisp,21,23,2,22,21
0071,vap_nhpi,0,0,0,0,0
0071,vap_other,0,12,12,7,2
0071,vap_two,10,22,12,17,12
0071,vap_white,146,103,-43,120,137
0072,pop,1941,1877,-64,1903,1928
0072,pop_aian,3,11,8,8,5
0072,pop_asian,201,173,-28,184,195
0072,pop_black,1367,1442,75,1412,1382
0072,pop_hisp,46,43,-3,44,45
0072,pop_nhpi,0,0,0,0,0
0072,pop_other,0,5,5,3,1
0072,pop_two,59,54,-5,56,58
0072,pop_white,265,149,-116,195,242
0072,vap,1298,1364,66,1338,1311
0072,vap_aian,3,8,5,6,4
0072,vap_asian,111,130,19,122,115
0072,vap_black,890,1020,130,968,916
0072,vap_hisp,31,26,-5,28,30
0072,vap_nhpi,0,0,0,0,0
0072,vap_other,0,0,0,0,0
0072,vap_two,29,34,5,32,30
0072,vap_white,234,146,-88,181,216
0073,pop,2073,1935,-138,1990,2045
0073,pop_aian,9,10,1,10,9
0073,pop_asian,213,231,18,224,217
0073,pop_black,1401,1306,-95,1344,1382
0073,pop_hisp,66,84,18,77,70
0073,pop_nhpi,0,0,0,0,0
0073,pop_other,1,2,1,2,1
0073,pop_two,33,71,38,56,41
0073,pop_white,350,231,-119,279,326
0073,vap,1469,1444,-25,1454,1464
0073,vap_aian,6,9,3,8,7
0073,vap_asian,147,150,3,149,148
0073,vap_black,929,975,46,957,938
0073,vap_hisp,41,55,14,49,44
0073,vap_nhpi,0,0,0,0,0
0073,vap_other,1,0,-1,0,1
0073,vap_two,17,36,19,28,21
0073,vap_white,328,219,-109,263,306
0074,pop,1235,1156,-79,1188,1219
0074,pop_aian,4,2,-2,3,4
0074,pop_asian,71,97,26,87,76
0074,pop_black,866,888,22,879,870
0074,pop_hisp,59,35,-24,45,54
0074,pop_nhpi,1,0,-1,0,1
0074,pop_other,0,0,0,0,0
0074,pop_two,27,30,3,29,28
0074,pop_white,207,104,-103,145,186
0074,vap,878,888,10,884,880
0074,vap_aian,3,2,-1,2,3
0074,vap_asian,45,61,16,55,48
0074,vap_black,602,686,84,652,619
0074,vap_hisp,37,24,-13,29,34
0074,vap_nhpi,1,0,-1,0,1
0074,vap_other,0,0,0,0,0
0074,vap_two,9,17,8,14,11
0074,vap_white,182,98,-84,132,165
0075,pop,1309,1396,87,1361,1326
0075,pop_aian,13,4,-9,8,11
0075,pop_asian,63,137,74,107,78
0075,pop_black,606,816,210,732,648
0075,pop_hisp,33,64,31,52,39
0075,pop_nhpi,3,0,-3,1,2
0075,pop_other,5,0,-5,2,4
0075,pop_two,62,57,-5,59,61
0075,pop_white,524,318,-206,400,483
0075,vap,955,1051,96,1013,974
0075,vap_aian,9,4,-5,6,8
0075,vap_asian,36,78,42,61,44
0075,vap_black,403,606,203,525,444
0075,vap_hisp,17,37,20,29,21
0075,vap_nhpi,3,0,-3,1,2
0075,vap_other,4,0,-4,2,3
0075,vap_two,28,33,5,31,29
0075,vap_white,455,293,-162,358,423
0076,pop,1489,1476,-13,1481,1486
0076,pop_aian,8,3,-5,5,7
0076,pop_asian,99,101,2,100,99
0076,pop_black,1007,1063,56,1041,1018
0076,pop_hisp,38,93,55,71,49
0076,pop_nhpi,0,0,0,0,0
0076,pop_other,1,8,7,5,2
0076,pop_two,51,39,-12,44,49
0076,pop_white,285,169,-116,215,262
0076,vap,1001,1028,27,1017,1006
0076,vap_aian,6,0,-6,2,5
0076,vap_asian,58,76,18,69,62
0076,vap_black,645,725,80,693,661
0076,vap_hisp,25,63,38,48,33
0076,vap_nhpi,0,0,0,0,0
0076,vap_other,1,3,2,2,1
0076,vap_two,18,22,4,20,19
0076,vap_white,247,139,-108,182,225
0077,pop,1400,1350,-50,1370,1390
0077,pop_aian,5,2,-3,3,4
0077,pop_asian,159,169,10,165,161
0077,pop_black,781,874,93,837,800
0077,pop_hisp,56,53,-3,54,55
0077,pop_nhpi,0,0,0,0,0
0077,pop_other,2,15,13,10,5
0077,pop_two,26,64,38,49,34
0077,pop_white,371,173,-198,252,331
0077,vap,1000,970,-30,982,994
0077,vap_aian,4,0,-4,2,3
0077,vap_asian,85,106,21,98,89
0077,vap_black,526,620,94,582,545
0077,vap_hisp,30,39,9,35,32
0077,vap_nhpi,0,0,0,0,0
0077,vap_other,0,7,7,4,1
0077,vap_two,10,37,27,26,15
0077,vap_white,345,161,-184,235,308
0078,pop,2437,2444,7,2441,2438
0078,pop_aian,8,4,-4,6,7
0078,pop_asian,113,259,146,201,142
0078,pop_black,1529,1628,99,1588,1549
0078,pop_hisp,104,87,-17,94,101
0078,pop_nhpi,0,1,1,1,0
0078,pop_other,1,11,10,7,3
0078,pop_two,119,96,-23,105,114
0078,pop_white,563,358,-205,440,522
0078,vap,1619,1680,61,1656,1631
0078,vap_aian,8,0,-8,3,6
0078,vap_asian,60,166,106,124,81
0078,vap_black,960,1085,125,1035,985
0078,vap_hisp,51,50,-1,50,51
0078,vap_nhpi,0,1,1,1,0
0078,vap_other,0,5,5,3,1
0078,vap_two,40,51,11,47,42
0078,vap_white,500,322,-178,393,464
0079,pop,2227,2246,19,2238,2231
0079,pop_aian,15,6,-9,10,13
0079,pop_asian,63,113,50,93,73
0079,pop_black,1235,1434,199,1354,1275
0079,pop_hisp,117,86,-31,98,111
0079,pop_nhpi,0,0,0,0,0
0079,pop_other,3,6,3,5,4
0079,pop_two,78,81,3,80,79
0079,pop_white,716,520,-196,598,677
0079,vap,1589,1697,108,1654,1611
0079,vap_aian,12,4,-8,7,10
0079,vap_asian,37,61,24,51,42
0079,vap_black,809,1056,247,957,858
0079,vap_hisp,60,51,-9,55,58
0079,vap_nhpi,0,0,0,0,0
0079,vap_other,2,2,0,2,2
0079,vap_two,26,49,23,40,31
0079,vap_white,643,474,-169,542,609
0080,pop,2935,3050,115,3004,2958
0080,pop_aian,10,8,-2,9,10
0080,pop_asian,121,128,7,125,122
0080,pop_black,944,1397,453,1216,1035
0080,pop_hisp,87,144,57,121,98
0080,pop_nhpi,1,0,-1,0,1
0080,pop_other,7,20,13,15,10
0080,pop_two,104,141,37,126,111
0080,pop_white,1661,1212,-449,1392,1571
0080,vap,2366,2379,13,2374,2369
0080,vap_aian,8,6,-2,7,8
0080,vap_asian,80,86,6,84,81
0080,vap_black,674,986,312,861,736
0080,vap_hisp,51,88,37,73,58
0080,vap_nhpi,1,0,-1,0,1
0080,vap_other,3,15,12,10,5
0080,vap_two,58,83,25,73,63
0080,vap_white,1491,1115,-376,1265,1416
0081,pop,1041,1098,57,1075,1052
0081,pop_aian,9,5,-4,7,8
0081,pop_asian,19,36,17,29,22
0081,pop_black,124,211,87,176,141
0081,pop_hisp,42,89,47,70,51
0081,pop_nhpi,0,0,0,0,0
0081,pop_other,2,6,4,4,3
0081,pop_two,10,61,51,41,20
0081,pop_white,835,690,-145,748,806
0081,vap,797,849,52,828,807
0081,vap_aian,6,3,-3,4,5
0081,vap_asian,16,32,16,26,19
0081,vap_black,85,134,49,114,95
0081,vap_hisp,26,51,25,41,31
0081,vap_nhpi,0,0,0,0,0
0081,vap_other,0,6,6,4,1
0081,vap_two,4,32,28,21,10
0081,vap_white,660,591,-69,619,646
0082,pop,1318,1299,-19,1307,1314
0082,pop_aian,7,6,-1,6,7
0082,pop_asian,26,24,-2,25,26
0082,pop_black,55,141,86,107,72
0082,pop_hisp,53,91,38,76,61
0082,pop_nhpi,0,1,1,1,0
0082,pop_other,0,1,1,1,0
0082,pop_two,18,71,53,50,29
0082,pop_white,1159,964,-195,1042,1120
0082,vap,1009,1026,17,1019,1012
0082,vap_aian,5,5,0,5,5
0082,vap_asian,18,24,6,22,19
0082,vap_black,45,95,50,75,55
0082,vap_hisp,26,66,40,50,34
0082,vap_nhpi,0,0,0,0,0
0082,vap_other,0,1,1,1,0
0082,vap_two,7,44,37,29,14
0082,vap_white,908,791,-117,838,885
0083,pop,1713,1698,-15,1704,1710
0083,pop_aian,5,3,-2,4,5
0083,pop_asian,47,57,10,53,49
0083,pop_black,155,360,205,278,196
0083,pop_hisp,111,110,-1,110,111
0083,pop_nhpi,1,5,4,3,2
0083,pop_other,2,4,2,3,2
0083,pop_two,51,111,60,87,63
0083,pop_white,1341,1048,-293,1165,1282
0083,vap,1295,1325,30,1313,1301
0083,vap_aian,5,1,-4,3,4
0083,vap_asian,34,48,14,42,37
0083,vap_black,108,258,150,198,138
0083,vap_hisp,61,75,14,69,64
0083,vap_nhpi,1,5,4,3,2
0083,vap_other,0,1,1,1,0
0083,vap_two,12,51,39,35,20
0083,vap_white,1074,886,-188,961,1036
0084,pop,1201,1208,7,1205,1202
0084,pop_aian,1,5,4,3,2
0084,pop_asian,27,32,5,30,28
0084,pop_black,123,203,80,171,139
0084,pop_hisp,74,103,29,91,80
0084,pop_nhpi,0,0,0,0,0
0084,pop_other,2,9,7,6,3
0084,pop_two,29,85,56,63,40
0084,pop_white,945,771,-174,841,910
0084,vap,924,943,19,935,928
0084,vap_aian,1,5,4,3,2
0084,vap_asian,18,22,4,20,19
0084,vap_black,77,143,66,117,90
0084,vap_hisp,37,67,30,55,43
0084,vap_nhpi,0,0,0,0,0
0084,vap_other,1,7,6,5,2
0084,vap_two,6,51,45,33,15
0084,vap_white,784,648,-136,702,757
0085,pop,1532,1425,-107,1468,1511
0085,pop_aian,6,10,4,8,7
0085,pop_asian,32,31,-1,31,32
0085,pop_black,85,101,16,95,88
0085,pop_hisp,50,69,19,61,54
0085,pop_nhpi,4,0,-4,2,3
0085,pop_other,1,12,11,8,3
0085,pop_two,35,60,25,50,40
0085,pop_white,1319,1142,-177,1213,1284
0085,vap,1215,1168,-47,1187,1206
0085,vap_aian,5,10,5,8,6
0085,vap_asian,25,26,1,26,25
0085,vap_black,68,76,8,73,70
0085,vap_hisp,37,51,14,45,40
0085,vap_nhpi,4,0,-4,2,3
0085,vap_other,0,9,9,5,2
0085,vap_two,17,35,18,28,21
0085,vap_white,1059,961,-98,1000,1039
0086,pop,1384,1361,-23,1370,1379
0086,pop_aian,4,1,-3,2,3
0086,pop_asian,37,27,-10,31,35
0086,pop_black,106,177,71,149,120
0086,pop_hisp,27,81,54,59,38
0086,pop_nhpi,1,0,-1,0,1
0086,pop_other,2,2,0,2,2
0086,pop_two,33,81,48,62,43
0086,pop_white,1174,992,-182,1065,1138
0086,vap,1110,1105,-5,1107,1109
0086,vap_aian,4,1,-3,2,3
0086,vap_asian,28,20,-8,23,26
0086,vap_black,83,128,45,110,92
0086,vap_hisp,17,48,31,36,23
0086,vap_nhpi,1,0,-1,0,1
0086,vap_other,2,2,0,2,2
0086,vap_two,14,47,33,34,21
0086,vap_white,961,859,-102,900,941
0087,pop,935,977,42,960,943
0087,pop_aian,3,0,-3,1,2
0087,pop_asian,14,14,0,14,14
0087,pop_black,161,190,29,178,167
0087,pop_hisp,26,59,33,46,33
0087,pop_nhpi,0,0,0,0,0
0087,pop_other,0,1,1,1,0
0087,pop_two,29,45,16,39,32
0087,pop_white,702,668,-34,682,695
0087,vap,747,740,-7,743,746
0087,vap_aian,3,0,-3,1,2
0087,vap_asian,12,13,1,13,12
0087,vap_black,112,117,5,115,113
0087,vap_hisp,12,33,21,25,16
0087,vap_nhpi,0,0,0,0,0
0087,vap_other,0,1,1,1,0
0087,vap_two,15,20,5,18,16
0087,vap_white,593,556,-37,571,586
0088,pop,1324,1309,-15,1315,1321
0088,pop_aian,9,5,-4,7,8
0088,pop_asian,7,24,17,17,10
0088,pop_black,208,365,157,302,239
0088,pop_hisp,74,72,-2,73,74
0088,pop_nhpi,3,0,-3,1,2
0088,pop_other,6,12,6,10,7
0088,pop_two,36,89,53,68,47
0088,pop_white,981,742,-239,838,933
0088,vap,995,1039,44,1021,1004
0088,vap_aian,6,5,-1,5,6
0088,vap_asian,5,17,12,12,7
0088,vap_black,144,268,124,218,169
0088,vap_hisp,41,54,13,49,44
0088,vap_nhpi,2,0,-2,1,2
0088,vap_other,2,11,9,7,4
0088,vap_two,12,36,24,26,17
0088,vap_white,783,648,-135,702,756
0089,pop,1856,1891,35,1877,1863
0089,pop_aian,10,2,-8,5,8
0089,pop_asian,24,75,51,55,34
0089,pop_black,458,734,276,624,513
0089,pop_hisp,89,104,15,98,92
0089,pop_nhpi,0,3,3,2,1
0089,pop_other,5,34,29,22,11
0089,pop_two,86,118,32,105,92
0089,pop_white,1184,821,-363,966,1111
0089,vap,1404,1383,-21,1391,1400
0089,vap_aian,7,2,-5,4,6
0089,vap_asian,20,50,30,38,26
0089,vap_black,325,499,174,429,360
0089,vap_hisp,45,64,19,56,49
0089,vap_nhpi,0,3,3,2,1
0089,vap_other,4,24,20,16,8
0089,vap_two,34,48,14,42,37
0089,vap_white,969,693,-276,803,914
0090,pop,1786,1767,-19,1775,1782
0090,pop_aian,10,5,-5,7,9
0090,pop_asian,120,140,20,132,124
0090,pop_black,588,786,198,707,628
0090,pop_hisp,79,115,36,101,86
0090,pop_nhpi,0,4,4,2,1
0090,pop_other,4,9,5,7,5
0090,pop_two,37,76,39,60,45
0090,pop_white,948,632,-316,758,885
0090,vap,1341,1382,41,1366,1349
0090,vap_aian,7,3,-4,5,6
0090,vap_asian,67,92,25,82,72
0090,vap_black,427,596,169,528,461
0090,vap_hisp,50,81,31,69,56
0090,vap_nhpi,0,4,4,2,1
0090,vap_other,3,4,1,4,3
0090,vap_two,13,35,22,26,17
0090,vap_white,774,567,-207,650,733
0091,pop,2632,2732,100,2692,2652
0091,pop_aian,7,8,1,8,7
0091,pop_asian,48,131,83,98,65
0091,pop_black,1833,2057,224,1967,1878
0091,pop_hisp,112,89,-23,98,107
0091,pop_nhpi,1,0,-1,0,1
0091,pop_other,5,13,8,10,7
0091,pop_two,67,113,46,95,76
0091,pop_white,559,321,-238,416,511
0091,vap,1912,1998,86,1964,1929
0091,vap_aian,4,8,4,6,5
0091,vap_asian,30,87,57,64,41
0091,vap_black,1283,1480,197,1401,1322
0091,vap_hisp,68,55,-13,60,65
0091,vap_nhpi,1,0,-1,0,1
0091,vap_other,4,6,2,5,4
0091,vap_two,26,62,36,48,33
0091,vap_white,496,300,-196,378,457
0092,pop,2437,2455,18,2448,2441
0092,pop_aian,9,4,-5,6,8
0092,pop_asian,17,18,1,18,17
0092,pop_black,776,1008,232,915,822
0092,pop_hisp,124,147,23,138,129
0092,pop_nhpi,1,1,0,1,1
0092,pop_other,6,7,1,7,6
0092,pop_two,105,121,16,115,108
0092,pop_white,1399,1149,-250,1249,1349
0092,vap,1827,1828,1,1828,1827
0092,vap_aian,8,2,-6,4,7
0092,vap_asian,14,12,-2,13,14
0092,vap_black,557,708,151,648,587
0092,vap_hisp,70,90,20,82,74
0092,vap_nhpi,1,1,0,1,1
0092,vap_other,2,7,5,5,3
0092,vap_two,39,62,23,53,44
0092,vap_white,1136,946,-190,1022,1098
0093,pop,1018,936,-82,969,1002
0093,pop_aian,2,3,1,3,2
0093,pop_asian,14,18,4,16,15
0093,pop_black,147,110,-37,125,140
0093,pop_hisp,38,48,10,44,40
0093,pop_nhpi,2,1,-1,1,2
0093,pop_other,0,7,7,4,1
0093,pop_two,23,45,22,36,27
0093,pop_white,792,704,-88,739,774
0093,vap,735,759,24,749,740
0093,vap_aian,1,3,2,2,1
0093,vap_asian,11,12,1,12,11
0093,vap_black,110,94,-16,100,107
0093,vap_hisp,21,29,8,26,23
0093,vap_nhpi,1,1,0,1,1
0093,vap_other,0,3,3,2,1
0093,vap_two,6,24,18,17,10
0093,vap_white,585,593,8,590,587
0094,pop,1293,1166,-127,1217,1268
0094,pop_aian,4,1,-3,2,3
0094,pop_asian,52,37,-15,43,49
0094,pop_black,924,958,34,944,931
0094,pop_hisp,58,44,-14,50,55
0094,pop_nhpi,0,0,0,0,0
0094,pop_other,0,9,9,5,2
0094,pop_two,38,30,-8,33,36
0094,pop_white,217,87,-130,139,191
0094,vap,979,873,-106,915,958
0094,vap_aian,4,1,-3,2,3
0094,vap_asian,31,26,-5,28,30
0094,vap_black,699,721,22,712,703
0094,vap_hisp,39,24,-15,30,36
0094,vap_nhpi,0,0,0,0,0
0094,vap_other,0,9,9,5,2
0094,vap_two,20,17,-3,18,19
0094,vap_white,186,75,-111,119,164
0095,pop,1086,1095,9,1091,1088
0095,pop_aian,6,0,-6,2,5
0095,pop_asian,20,41,21,33,24
0095,pop_black,804,846,42,829,812
0095,pop_hisp,56,57,1,57,56
0095,pop_nhpi,0,0,0,0,0
0095,pop_other,4,4,0,4,4
0095,pop_two,22,42,20,34,26
0095,pop_white,174,105,-69,133,160
0095,vap,759,786,27,775,764
0095,vap_aian,3,0,-3,1,2
0095,vap_asian,10,23,13,18,13
0095,vap_black,538,608,70,580,552
0095,vap_hisp,29,33,4,31,30
0095,vap_nhpi,0,0,0,0,0
0095,vap_other,3,2,-1,2,3
0095,vap_two,13,26,13,21,16
0095,vap_white,163,94,-69,122,149
0096,pop,1811,1757,-54,1779,1800
0096,pop_aian,6,3,-3,4,5
0096,pop_asian,17,23,6,21,18
0096,pop_black,1121,1166,45,1148,1130
0096,pop_hisp,71,97,26,87,76
0096,pop_nhpi,0,1,1,1,0
0096,pop_other,8,15,7,12,9
0096,pop_two,51,54,3,53,52
0096,pop_white,537,398,-139,454,509
0096,vap,1300,1357,57,1334,1311
0096,vap_aian,6,2,-4,4,5
0096,vap_asian,12,15,3,14,13
0096,vap_black,792,902,110,858,814
0096,vap_hisp,43,61,18,54,47
0096,vap_nhpi,0,1,1,1,0
0096,vap_other,3,6,3,5,4
0096,vap_two,26,36,10,32,28
0096,vap_white,418,334,-84,368,401
0097,pop,1769,1677,-92,1714,1751
0097,pop_aian,1,2,1,2,1
0097,pop_asian,15,31,16,25,18
0097,pop_black,954,925,-29,937,948
0097,pop_hisp,61,73,12,68,63
0097,pop_nhpi,0,2,2,1,0
0097,pop_other,2,24,22,15,6
0097,pop_two,42,61,19,53,46
0097,pop_white,694,559,-135,613,667
0097,vap,1213,1198,-15,1204,1210
0097,vap_aian,1,2,1,2,1
0097,vap_asian,10,22,12,17,12
0097,vap_black,673,684,11,680,675
0097,vap_hisp,40,46,6,44,41
0097,vap_nhpi,0,2,2,1,0
0097,vap_other,2,16,14,10,5
0097,vap_two,19,34,15,28,22
0097,vap_white,468,392,-76,422,453
0098,pop,1060,1042,-18,1049,1056
0098,pop_aian,5,4,-1,4,5
0098,pop_asian,10,14,4,12,11
0098,pop_black,880,857,-23,866,875
0098,pop_hisp,26,50,24,40,31
0098,pop_nhpi,0,2,2,1,0
0098,pop_other,5,5,0,5,5
0098,pop_two,23,38,15,32,26
0098,pop_white,111,72,-39,88,103
0098,vap,778,833,55,811,789
0098,vap_aian,3,3,0,3,3
0098,vap_asian,8,10,2,9,8
0098,vap_black,633,697,64,671,646
0098,vap_hisp,16,33,17,26,19
0098,vap_nhpi,0,2,2,1,0
0098,vap_other,3,4,1,4,3
0098,vap_two,14,25,11,21,16
0098,vap_white,101,59,-42,76,93
0099,pop,2108,2012,-96,2050,2089
0099,pop_aian,1,6,5,4,2
0099,pop_asian,16,38,22,29,20
0099,pop_black,1622,1538,-84,1572,1605
0099,pop_hisp,79,98,19,90,83
0099,pop_nhpi,0,0,0,0,0
0099,pop_other,4,12,8,9,6
0099,pop_two,56,76,20,68,60
0099,pop_white,330,244,-86,278,313
0099,vap,1460,1436,-24,1446,1455
0099,vap_aian,0,4,4,2,1
0099,vap_asian,12,24,12,19,14
0099,vap_black,1120,1105,-15,1111,1117
0099,vap_hisp,40,63,23,54,45
0099,vap_nhpi,0,0,0,0,0
0099,vap_other,3,12,9,8,5
0099,vap_two,32,55,23,46,37
0099,vap_white,253,173,-80,205,237
0100,pop,1300,1233,-67,1260,1287
0100,pop_aian,1,5,4,3,2
0100,pop_asian,3,14,11,10,5
0100,pop_black,1175,1073,-102,1114,1155
0100,pop_hisp,24,47,23,38,29
0100,pop_nhpi,0,2,2,1,0
0100,pop_other,0,6,6,4,1
0100,pop_two,21,30,9,26,23
0100,pop_white,76,56,-20,64,72
0100,vap,971,927,-44,945,962
0100,vap_aian,1,4,3,3,2
0100,vap_asian,3,12,9,8,5
0100,vap_black,864,815,-49,835,854
0100,vap_hisp,17,22,5,20,18
0100,vap_nhpi,0,2,2,1,0
0100,vap_other,0,4,4,2,1
0100,vap_two,13,15,2,14,13
0100,vap_white,73,53,-20,61,69
0101,pop,1891,1857,-34,1871,1884
0101,pop_aian,3,7,4,5,4
0101,pop_asian,21,16,-5,18,20
0101,pop_black,1719,1665,-54,1687,1708
0101,pop_hisp,42,66,24,56,47
0101,pop_nhpi,0,0,0,0,0
0101,pop_other,0,8,8,5,2
0101,pop_two,41,49,8,46,43
0101,pop_white,65,46,-19,54,61
0101,vap,1333,1366,33,1353,1340
0101,vap_aian,3,5,2,4,3
0101,vap_asian,13,10,-3,11,12
0101,vap_black,1209,1229,20,1221,1213
0101,vap_hisp,24,44,20,36,28
0101,vap_nhpi,0,0,0,0,0
0101,vap_other,0,5,5,3,1
0101,vap_two,21,32,11,28,23
0101,vap_white,63,41,-22,50,59
0102,pop,2290,2219,-71,2247,2276
0102,pop_aian,9,11,2,10,9
0102,pop_asian,3,34,31,22,9
0102,pop_black,1964,1824,-140,1880,1936
0102,pop_hisp,58,88,30,76,64
0102,pop_nhpi,0,0,0,0,0
0102,pop_other,3,10,7,7,4
0102,pop_two,56,81,25,71,61
0102,pop_white,197,171,-26,181,192
0102,vap,1614,1652,38,1637,1622
0102,vap_aian,7,11,4,9,8
0102,vap_asian,3,21,18,14,7
0102,vap_black,1382,1378,-4,1380,1381
0102,vap_hisp,29,59,30,47,35
0102,vap_nhpi,0,0,0,0,0
0102,vap_other,1,9,8,6,3
0102,vap_two,30,44,14,38,33
0102,vap_white,162,130,-32,143,156
0103,pop,3080,2801,-279,2913,3024
0103,pop_aian,14,1,-13,6,11
0103,pop_asian,22,44,22,35,26
0103,pop_black,2640,2345,-295,2463,2581
0103,pop_hisp,92,117,25,107,97
0103,pop_nhpi,0,0,0,0,0
0103,pop_other,2,15,13,10,5
0103,pop_two,59,70,11,66,61
0103,pop_white,251,209,-42,226,243
0103,vap,2080,2005,-75,2035,2065
0103,vap_aian,8,1,-7,4,7
0103,vap_asian,18,30,12,25,20
0103,vap_black,1762,1653,-109,1697,1740
0103,vap_hisp,54,84,30,72,60
0103,vap_nhpi,0,0,0,0,0
0103,vap_other,1,7,6,5,2
0103,vap_two,25,48,23,39,30
0103,vap_white,212,182,-30,194,206
0104,pop,2929,2594,-335,2728,2862
0104,pop_aian,7,5,-2,6,7
0104,pop_asian,39,10,-29,22,33
0104,pop_black,2663,2322,-341,2458,2595
0104,pop_hisp,81,98,17,91,84
0104,pop_nhpi,0,0,0,0,0
0104,pop_other,2,24,22,15,6
0104,pop_two,57,71,14,65,60
0104,pop_white,80,64,-16,70,77
0104,vap,1949,1824,-125,1874,1924
0104,vap_aian,4,5,1,5,4
0104,vap_asian,21,8,-13,13,18
0104,vap_black,1769,1628,-141,1684,1741
0104,vap_hisp,54,71,17,64,57
0104,vap_nhpi,0,0,0,0,0
0104,vap_other,1,19,18,12,5
0104,vap_two,28,35,7,32,29
0104,vap_white,72,58,-14,64,69
0105,pop,1583,1202,-381,1354,1507
0105,pop_aian,3,0,-3,1,2
0105,pop_asian,14,4,-10,8,12
0105,pop_black,1460,1084,-376,1234,1385
0105,pop_hisp,33,29,-4,31,32
0105,pop_nhpi,0,2,2,1,0
0105,pop_other,0,6,6,4,1
0105,pop_two,43,53,10,49,45
0105,pop_white,30,24,-6,26,29
0105,vap,989,848,-141,904,961
0105,vap_aian,3,0,-3,1,2
0105,vap_asian,14,0,-14,6,11
0105,vap_black,915,774,-141,830,887
0105,vap_hisp,17,15,-2,16,17
0105,vap_nhpi,0,2,2,1,0
0105,vap_other,0,3,3,2,1
0105,vap_two,14,33,19,25,18
0105,vap_white,26,21,-5,23,25
0106,pop,1295,1106,-189,1182,1257
0106,pop_aian,1,2,1,2,1
0106,pop_asian,19,12,-7,15,18
0106,pop_black,1202,998,-204,1080,1161
0106,pop_hisp,35,51,16,45,38
0106,pop_nhpi,0,0,0,0,0
0106,pop_other,0,6,6,4,1
0106,pop_two,26,24,-2,25,26
0106,pop_white,12,13,1,13,12
0106,vap,831,722,-109,766,809
0106,vap_aian,1,2,1,2,1
0106,vap_asian,7,2,-5,4,6
0106,vap_black,779,659,-120,707,755
0106,vap_hisp,22,29,7,26,23
0106,vap_nhpi,0,0,0,0,0
0106,vap_other,0,3,3,2,1
0106,vap_two,11,16,5,14,12
0106,vap_white,11,11,0,11,11
0107,pop,1659,1568,-91,1604,1641
0107,pop_aian,5,4,-1,4,5
0107,pop_asian,1,8,7,5,2
0107,pop_black,1560,1444,-116,1490,1537
0107,pop_hisp,38,25,-13,30,35
0107,pop_nhpi,0,0,0,0,0
0107,pop_other,3,7,4,5,4
0107,pop_two,23,48,25,38,28
0107,pop_white,29,32,3,31,30
0107,vap,1162,1141,-21,1149,1158
0107,vap_aian,3,4,1,4,3
0107,vap_asian,1,2,1,2,1
0107,vap_black,1095,1052,-43,1069,1086
0107,vap_hisp,28,16,-12,21,26
0107,vap_nhpi,0,0,0,0,0
0107,vap_other,1,7,6,5,2
0107,vap_two,10,28,18,21,14
0107,vap_white,24,32,8,29,26
0108,pop,1561,1422,-139,1478,1533
0108,pop_aian,1,0,-1,0,1
0108,pop_asian,5,3,-2,4,5
0108,pop_black,1462,1336,-126,1386,1437
0108,pop_hisp,21,30,9,26,23
0108,pop_nhpi,0,0,0,0,0
0108,pop_other,5,1,-4,3,4
0108,pop_two,35,45,10,41,37
0108,pop_white,32,7,-25,17,27
0108,vap,1105,1054,-51,1074,1095
0108,vap_aian,1,0,-1,0,1
0108,vap_asian,4,2,-2,3,4
0108,vap_black,1045,995,-50,1015,1035
0108,vap_hisp,14,22,8,19,16
0108,vap_nhpi,0,0,0,0,0
0108,vap_other,0,1,1,1,0
0108,vap_two,15,27,12,22,17
0108,vap_white,26,7,-19,15,22
0109,pop,2154,1704,-450,1884,2064
0109,pop_aian,3,10,7,7,4
0109,pop_asian,5,14,9,10,7
0109,pop_black,2076,1563,-513,1768,1973
0109,pop_hisp,30,37,7,34,31
0109,pop_nhpi,1,0,-1,0,1
0109,pop_other,1,7,6,5,2
0109,pop_two,22,43,21,35,26
0109,pop_white,16,30,14,24,19
0109,vap,1438,1141,-297,1260,1379
0109,vap_aian,3,10,7,7,4
0109,vap_asian,3,10,7,7,4
0109,vap_black,1385,1051,-334,1185,1318
0109,vap_hisp,15,23,8,20,17
0109,vap_nhpi,1,0,-1,0,1
0109,vap_other,0,7,7,4,1
0109,vap_two,16,18,2,17,16
0109,vap_white,15,22,7,19,16
0110,pop,1381,1060,-321,1188,1317
0110,pop_aian,9,1,-8,4,7
0110,pop_asian,8,7,-1,7,8
0110,pop_black,1298,961,-337,1096,1231
0110,pop_hisp,33,40,7,37,34
0110,pop_nhpi,0,0,0,0,0
0110,pop_other,0,8,8,5,2
0110,pop_two,20,29,9,25,22
0110,pop_white,13,14,1,14,13
0110,vap,877,690,-187,765,840
0110,vap_aian,4,1,-3,2,3
0110,vap_asian,5,7,2,6,5
0110,vap_black,826,619,-207,702,785
0110,vap_hisp,21,32,11,28,23
0110,vap_nhpi,0,0,0,0,0
0110,vap_other,0,4,4,2,1
0110,vap_two,8,16,8,13,10
0110,vap_white,13,11,-2,12,13
0111,pop,1988,1477,-511,1681,1886
0111,pop_aian,6,4,-2,5,6
0111,pop_asian,12,4,-8,7,10
0111,pop_black,1882,1315,-567,1542,1769
0111,pop_hisp,20,87,67,60,33
0111,pop_nhpi,0,0,0,0,0
0111,pop_other,3,21,18,14,7
0111,pop_two,38,24,-14,30,35
0111,pop_white,27,22,-5,24,26
0111,vap,1251,1006,-245,1104,1202
0111,vap_aian,4,2,-2,3,4
0111,vap_asian,10,4,-6,6,9
0111,vap_black,1183,896,-287,1011,1126
0111,vap_hisp,11,56,45,38,20
0111,vap_nhpi,0,0,0,0,0
0111,vap_other,2,12,10,8,4
0111,vap_two,15,17,2,16,15
0111,vap_white,26,19,-7,22,25
0112,pop,1937,1448,-489,1644,1839
0112,pop_aian,5,3,-2,4,5
0112,pop_asian,1,3,2,2,1
0112,pop_black,1836,1345,-491,1541,1738
0112,pop_hisp,44,36,-8,39,42
0112,pop_nhpi,0,0,0,0,0
0112,pop_other,6,4,-2,5,6
0112,pop_two,36,37,1,37,36
0112,pop_white,9,20,11,16,11
0112,vap,1261,1004,-257,1107,1210
0112,vap_aian,5,2,-3,3,4
0112,vap_asian,0,3,3,2,1
0112,vap_black,1206,930,-276,1040,1151
0112,vap_hisp,19,23,4,21,20
0112,vap_nhpi,0,0,0,0,0
0112,vap_other,2,4,2,3,2
0112,vap_two,21,22,1,22,21
0112,vap_white,8,20,12,15,10
0113,pop,1767,1369,-398,1528,1687
0113,pop_aian,1,7,6,5,2
0113,pop_asian,4,7,3,6,5
0113,pop_black,1681,1274,-407,1437,1600
0113,pop_hisp,29,39,10,35,31
0113,pop_nhpi,1,0,-1,0,1
0113,pop_other,0,7,7,4,1
0113,pop_two,35,25,-10,29,33
0113,pop_white,16,10,-6,12,15
0113,vap,1199,974,-225,1064,1154
0113,vap_aian,1,4,3,3,2
0113,vap_asian,4,7,3,6,5
0113,vap_black,1139,910,-229,1002,1093
0113,vap_hisp,17,34,17,27,20
0113,vap_nhpi,1,0,-1,0,1
0113,vap_other,0,1,1,1,0
0113,vap_two,24,10,-14,16,21
0113,vap_white,13,8,-5,10,12
0114,pop,1223,1122,-101,1162,1203
0114,pop_aian,17,0,-17,7,14
0114,pop_asian,6,3,-3,4,5
0114,pop_black,1139,1050,-89,1086,1121
0114,pop_hisp,28,26,-2,27,28
0114,pop_nhpi,0,0,0,0,0
0114,pop_other,1,0,-1,0,1
0114,pop_two,20,26,6,24,21
0114,pop_white,12,17,5,15,13
0114,vap,875,802,-73,831,860
0114,vap_aian,8,0,-8,3,6
0114,vap_asian,4,1,-3,2,3
0114,vap_black,824,763,-61,787,812
0114,vap_hisp,14,11,-3,12,13
0114,vap_nhpi,0,0,0,0,0
0114,vap_other,1,0,-1,0,1
0114,vap_two,12,13,1,13,12
0114,vap_white,12,14,2,13,12
0115,pop,2188,2032,-156,2094,2157
0115,pop_aian,1,7,6,5,2
0115,pop_asian,24,12,-12,17,22
0115,pop_black,2044,1869,-175,1939,2009
0115,pop_hisp,49,45,-4,47,48
0115,pop_nhpi,0,2,2,1,0
0115,pop_other,2,9,7,6,3
0115,pop_two,49,53,4,51,50
0115,pop_white,19,35,16,29,22
0115,vap,1542,1412,-130,1464,1516
0115,vap_aian,0,1,1,1,0
0115,vap_asian,13,9,-4,11,12
0115,vap_black,1459,1316,-143,1373,1430
0115,vap_hisp,26,22,-4,24,25
0115,vap_nhpi,0,2,2,1,0
0115,vap_other,2,8,6,6,3
0115,vap_two,23,26,3,25,24
0115,vap_white,19,28,9,24,21
0116,pop,1552,1243,-309,1367,1490
0116,pop_aian,4,1,-3,2,3
0116,pop_asian,0,0,0,0,0
0116,pop_black,1473,1115,-358,1258,1401
0116,pop_hisp,51,56,5,54,52
0116,pop_nhpi,0,0,0,0,0
0116,pop_other,0,1,1,1,0
0116,pop_two,11,46,35,32,18
0116,pop_white,13,24,11,20,15
0116,vap,1015,831,-184,905,978
0116,vap_aian,2,0,-2,1,2
0116,vap_asian,0,0,0,0,0
0116,vap_black,966,737,-229,829,920
0116,vap_hisp,26,35,9,31,28
0116,vap_nhpi,0,0,0,0,0
0116,vap_other,0,1,1,1,0
0116,vap_two,9,34,25,24,14
0116,vap_white,12,24,12,19,14
0117,pop,1594,1215,-379,1367,1518
0117,pop_aian,0,6,6,4,1
0117,pop_asian,0,0,0,0,0
0117,pop_black,1520,1110,-410,1274,1438
0117,pop_hisp,37,39,2,38,37
0117,pop_nhpi,0,0,0,0,0
0117,pop_other,0,0,0,0,0
0117,pop_two,9,33,24,23,14
0117,pop_white,28,27,-1,27,28
0117,vap,1030,794,-236,888,983
0117,vap_aian,0,5,5,3,1
0117,vap_asian,0,0,0,0,0
0117,vap_black,984,718,-266,824,931
0117,vap_hisp,17,29,12,24,19
0117,vap_nhpi,0,0,0,0,0
0117,vap_other,0,0,0,0,0
0117,vap_two,5,20,15,14,8
0117,vap_white,24,22,-2,23,24
0118,pop,1566,1352,-214,1438,1523
0118,pop_aian,2,0,-2,1,2
0118,pop_asian,18,8,-10,12,16
0118,pop_black,1420,1178,-242,1275,1372
0118,pop_hisp,64,80,16,74,67
0118,pop_nhpi,0,0,0,0,0
0118,pop_other,1,2,1,2,1
0118,pop_two,9,42,33,29,16
0118,pop_white,52,42,-10,46,50
0118,vap,1104,938,-166,1004,1071
0118,vap_aian,2,0,-2,1,2
0118,vap_asian,13,8,-5,10,12
0118,vap_black,1005,813,-192,890,967
0118,vap_hisp,28,55,27,44,33
0118,vap_nhpi,0,0,0,0,0
0118,vap_other,0,1,1,1,0
0118,vap_two,7,25,18,18,11
0118,vap_white,49,36,-13,41,46
0119,pop,1810,1512,-298,1631,1750
0119,pop_aian,6,3,-3,4,5
0119,pop_asian,2,14,12,9,4
0119,pop_black,1675,1325,-350,1465,1605
0119,pop_hisp,75,85,10,81,77
0119,pop_nhpi,0,0,0,0,0
0119,pop_other,10,2,-8,5,8
0119,pop_two,9,37,28,26,15
0119,pop_white,33,46,13,41,36
0119,vap,1218,1046,-172,1115,1184
0119,vap_aian,4,3,-1,3,4
0119,vap_asian,2,9,7,6,3
0119,vap_black,1123,929,-194,1007,1084
0119,vap_hisp,48,46,-2,47,48
0119,vap_nhpi,0,0,0,0,0
0119,vap_other,3,2,-1,2,3
0119,vap_two,6,23,17,16,9
0119,vap_white,32,34,2,33,32
0120,pop,1845,1521,-324,1651,1780
0120,pop_aian,10,9,-1,9,10
0120,pop_asian,7,2,-5,4,6
0120,pop_black,1579,1197,-382,1350,1503
0120,pop_hisp,112,171,59,147,124
0120,pop_nhpi,0,0,0,0,0
0120,pop_other,5,11,6,9,6
0120,pop_two,31,42,11,38,33
0120,pop_white,101,89,-12,94,99
0120,vap,1170,1032,-138,1087,1142
0120,vap_aian,7,6,-1,6,7
0120,vap_asian,4,2,-2,3,4
0120,vap_black,980,788,-192,865,942
0120,vap_hisp,66,114,48,95,76
0120,vap_nhpi,0,0,0,0,0
0120,vap_other,3,9,6,7,4
0120,vap_two,14,25,11,21,16
0120,vap_white,96,88,-8,91,94
0121,pop,1841,1627,-214,1713,1798
0121,pop_aian,3,10,7,7,4
0121,pop_asian,3,3,0,3,3
0121,pop_black,1706,1394,-312,1519,1644
0121,pop_hisp,64,84,20,76,68
0121,pop_nhpi,0,0,0,0,0
0121,pop_other,2,10,8,7,4
0121,pop_two,47,57,10,53,49
0121,pop_white,16,69,53,48,27
0121,vap,1191,1112,-79,1144,1175
0121,vap_aian,3,8,5,6,4
0121,vap_asian,3,2,-1,2,3
0121,vap_black,1119,955,-164,1021,1086
0121,vap_hisp,34,46,12,41,36
0121,vap_nhpi,0,0,0,0,0
0121,vap_other,0,8,8,5,2
0121,vap_two,20,40,20,32,24
0121,vap_white,12,53,41,37,20
0122,pop,2071,1860,-211,1944,2029
0122,pop_aian,4,3,-1,3,4
0122,pop_asian,1,6,5,4,2
0122,pop_black,1774,1372,-402,1533,1694
0122,pop_hisp,143,207,64,181,156
0122,pop_nhpi,1,0,-1,0,1
0122,pop_other,3,2,-1,2,3
0122,pop_two,60,100,40,84,68
0122,pop_white,85,170,85,136,102
0122,vap,1334,1236,-98,1275,1314
0122,vap_aian,4,0,-4,2,3
0122,vap_asian,1,6,5,4,2
0122,vap_black,1133,914,-219,1002,1089
0122,vap_hisp,83,133,50,113,93
0122,vap_nhpi,1,0,-1,0,1
0122,vap_other,3,1,-2,2,3
0122,vap_two,29,47,18,40,33
0122,vap_white,80,135,55,113,91
0123,pop,2332,2045,-287,2160,2275
0123,pop_aian,24,20,-4,22,23
0123,pop_asian,6,11,5,9,7
0123,pop_black,1222,957,-265,1063,1169
0123,pop_hisp,436,358,-78,389,420
0123,pop_nhpi,0,0,0,0,0
0123,pop_other,11,6,-5,8,10
0123,pop_two,88,89,1,89,88
0123,pop_white,545,604,59,580,557
0123,vap,1588,1496,-92,1533,1570
0123,vap_aian,22,17,-5,19,21
0123,vap_asian,5,7,2,6,5
0123,vap_black,748,635,-113,680,725
0123,vap_hisp,279,232,-47,251,270
0123,vap_nhpi,0,0,0,0,0
0123,vap_other,8,6,-2,7,8
0123,vap_two,42,62,20,54,46
0123,vap_white,484,537,53,516,495
0124,pop,1523,1170,-353,1311,1452
0124,pop_aian,4,1,-3,2,3
0124,pop_asian,92,63,-29,75,86
0124,pop_black,672,514,-158,577,640
0124,pop_hisp,72,99,27,88,77
0124,pop_nhpi,0,0,0,0,0
0124,pop_other,4,4,0,4,4
0124,pop_two,32,60,28,49,38
0124,pop_white,647,429,-218,516,603
0124,vap,1365,1025,-340,1161,1297
0124,vap_aian,2,0,-2,1,2
0124,vap_asian,77,61,-16,67,74
0124,vap_black,583,435,-148,494,553
0124,vap_hisp,54,68,14,62,57
0124,vap_nhpi,0,0,0,0,0
0124,vap_other,2,4,2,3,2
0124,vap_two,20,36,16,30,23
0124,vap_white,627,421,-206,503,586
0125,pop,1825,1766,-59,1790,1813
0125,pop_aian,21,6,-15,12,18
0125,pop_asian,14,32,18,25,18
0125,pop_black,157,151,-6,153,156
0125,pop_hisp,216,223,7,220,217
0125,pop_nhpi,0,0,0,0,0
0125,pop_other,1,11,10,7,3
0125,pop_two,80,107,27,96,85
0125,pop_white,1336,1236,-100,1276,1316
0125,vap,1537,1525,-12,1530,1535
0125,vap_aian,16,4,-12,9,14
0125,vap_asian,14,27,13,22,17
0125,vap_black,112,114,2,113,112
0125,vap_hisp,155,158,3,157,156
0125,vap_nhpi,0,0,0,0,0
0125,vap_other,1,10,9,6,3
0125,vap_two,39,74,35,60,46
0125,vap_white,1200,1138,-62,1163,1188
0126,pop,1245,1220,-25,1230,1240
0126,pop_aian,1,0,-1,0,1
0126,pop_asian,14,13,-1,13,14
0126,pop_black,327,318,-9,322,325
0126,pop_hisp,83,76,-7,79,82
0126,pop_nhpi,0,0,0,0,0
0126,pop_other,0,5,5,3,1
0126,pop_two,40,76,36,62,47
0126,pop_white,780,732,-48,751,770
0126,vap,1094,1109,15,1103,1097
0126,vap_aian,1,0,-1,0,1
0126,vap_asian,12,13,1,13,12
0126,vap_black,285,278,-7,281,284
0126,vap_hisp,56,64,8,61,58
0126,vap_nhpi,0,0,0,0,0
0126,vap_other,0,2,2,1,0
0126,vap_two,22,62,40,46,30
0126,vap_white,718,690,-28,701,712
0127,pop,2400,2859,459,2675,2492
0127,pop_aian,12,4,-8,7,10
0127,pop_asian,113,123,10,119,115
0127,pop_black,53,104,51,84,63
0127,pop_hisp,84,202,118,155,108
0127,pop_nhpi,1,1,0,1,1
0127,pop_other,4,79,75,49,19
0127,pop_two,35,96,61,72,47
0127,pop_white,2098,2250,152,2189,2128
0127,vap,2273,2657,384,2503,2350
0127,vap_aian,10,3,-7,6,9
0127,vap_asian,110,112,2,111,110
0127,vap_black,47,84,37,69,54
0127,vap_hisp,65,166,101,126,85
0127,vap_nhpi,1,0,-1,0,1
0127,vap_other,3,77,74,47,18
0127,vap_two,26,78,52,57,36
0127,vap_white,2011,2137,126,2087,2036
0128,pop,2886,2862,-24,2872,2881
0128,pop_aian,5,13,8,10,7
0128,pop_asian,69,109,40,93,77
0128,pop_black,55,137,82,104,71
0128,pop_hisp,88,185,97,146,107
0128,pop_nhpi,1,0,-1,0,1
0128,pop_other,5,33,28,22,11
0128,pop_two,49,127,78,96,65
0128,pop_white,2614,2258,-356,2400,2543
0128,vap,2759,2664,-95,2702,2740
0128,vap_aian,5,13,8,10,7
0128,vap_asian,62,109,47,90,71
0128,vap_black,51,107,56,85,62
0128,vap_hisp,83,172,89,136,101
0128,vap_nhpi,1,0,-1,0,1
0128,vap_other,1,18,17,11,4
0128,vap_two,42,104,62,79,54
0128,vap_white,2514,2141,-373,2290,2439
0129,pop,1780,1725,-55,1747,1769
0129,pop_aian,1,1,0,1,1
0129,pop_asian,46,88,42,71,54
0129,pop_black,38,67,29,55,44
0129,pop_hisp,45,91,46,73,54
0129,pop_nhpi,0,0,0,0,0
0129,pop_other,15,16,1,16,15
0129,pop_two,31,53,22,44,35
0129,pop_white,1604,1409,-195,1487,1565
0129,vap,1580,1488,-92,1525,1562
0129,vap_aian,1,1,0,1,1
0129,vap_asian,39,81,42,64,47
0129,vap_black,28,65,37,50,35
0129,vap_hisp,38,66,28,55,44
0129,vap_nhpi,0,0,0,0,0
0129,vap_other,3,7,4,5,4
0129,vap_two,23,40,17,33,26
0129,vap_white,1448,1228,-220,1316,1404
0130,pop,2765,2188,-577,2419,2650
0130,pop_aian,8,0,-8,3,6
0130,pop_asian,59,35,-24,45,54
0130,pop_black,99,16,-83,49,82
0130,pop_hisp,96,126,30,114,102
0130,pop_nhpi,1,0,-1,0,1
0130,pop_other,22,219,197,140,61
0130,pop_two,43,26,-17,33,40
0130,pop_white,2437,1766,-671,2034,2303
0130,vap,2744,2159,-585,2393,2627
0130,vap_aian,8,0,-8,3,6
0130,vap_asian,57,31,-26,41,52
0130,vap_black,98,9,-89,45,80
0130,vap_hisp,95,125,30,113,101
0130,vap_nhpi,1,0,-1,0,1
0130,vap_other,22,219,197,140,61
0130,vap_two,43,19,-24,29,38
0130,vap_white,2420,1756,-664,2022,2287
0131,pop,1735,1731,-4,1733,1734
0131,pop_aian,2,3,1,3,2
0131,pop_asian,25,63,38,48,33
0131,pop_black,37,47,10,43,39
0131,pop_hisp,83,87,4,85,84
0131,pop_nhpi,0,0,0,0,0
0131,pop_other,1,16,15,10,4
0131,pop_two,20,73,53,52,31
0131,pop_white,1567,1442,-125,1492,1542
0131,vap,1431,1406,-25,1416,1426
0131,vap_aian,2,3,1,3,2
0131,vap_asian,24,53,29,41,30
0131,vap_black,29,41,12,36,31
0131,vap_hisp,61,68,7,65,62
0131,vap_nhpi,0,0,0,0,0
0131,vap_other,1,15,14,9,4
0131,vap_two,13,40,27,29,18
0131,vap_white,1301,1186,-115,1232,1278
0132,pop,2242,2352,110,2308,2264
0132,pop_aian,1,9,8,6,3
0132,pop_asian,44,31,-13,36,41
0132,pop_black,48,104,56,82,59
0132,pop_hisp,38,102,64,76,51
0132,pop_nhpi,0,0,0,0,0
0132,pop_other,1,22,21,14,5
0132,pop_two,35,84,49,64,45
0132,pop_white,2075,2000,-75,2030,2060
0132,vap,2004,2055,51,2035,2014
0132,vap_aian,1,9,8,6,3
0132,vap_asian,37,22,-15,28,34
0132,vap_black,40,103,63,78,53
0132,vap_hisp,28,73,45,55,37
0132,vap_nhpi,0,0,0,0,0
0132,vap_other,1,17,16,11,4
0132,vap_two,18,55,37,40,25
0132,vap_white,1879,1776,-103,1817,1858
0133,pop,1463,1404,-59,1428,1451
0133,pop_aian,2,4,2,3,2
0133,pop_asian,39,54,15,48,42
0133,pop_black,46,75,29,63,52
0133,pop_hisp,35,104,69,76,49
0133,pop_nhpi,1,2,1,2,1
0133,pop_other,0,6,6,4,1
0133,pop_two,18,57,39,41,26
0133,pop_white,1321,1102,-219,1190,1277
0133,vap,1432,1323,-109,1367,1410
0133,vap_aian,1,4,3,3,2
0133,vap_asian,36,53,17,46,39
0133,vap_black,46,73,27,62,51
0133,vap_hisp,33,96,63,71,46
0133,vap_nhpi,1,2,1,2,1
0133,vap_other,0,1,1,1,0
0133,vap_two,16,47,31,35,22
0133,vap_white,1298,1047,-251,1147,1248
0134,pop,1746,1717,-29,1729,1740
0134,pop_aian,4,1,-3,2,3
0134,pop_asian,139,131,-8,134,137
0134,pop_black,73,130,57,107,84
0134,pop_hisp,53,159,106,117,74
0134,pop_nhpi,3,0,-3,1,2
0134,pop_other,1,12,11,8,3
0134,pop_two,39,70,31,58,45
0134,pop_white,1434,1214,-220,1302,1390
0134,vap,1682,1642,-40,1658,1674
0134,vap_aian,4,0,-4,2,3
0134,vap_asian,133,126,-7,129,132
0134,vap_black,65,113,48,94,75
0134,vap_hisp,49,149,100,109,69
0134,vap_nhpi,3,0,-3,1,2
0134,vap_other,1,11,10,7,3
0134,vap_two,27,57,30,45,33
0134,vap_white,1400,1186,-214,1272,1357
0135,pop,1655,2105,450,1925,1745
0135,pop_aian,9,7,-2,8,9
0135,pop_asian,95,219,124,169,120
0135,pop_black,94,207,113,162,117
0135,pop_hisp,74,143,69,115,88
0135,pop_nhpi,1,3,2,2,1
0135,pop_other,6,12,6,10,7
0135,pop_two,30,91,61,67,42
0135,pop_white,1347,1423,76,1393,1362
0135,vap,1597,1995,398,1836,1677
0135,vap_aian,7,6,-1,6,7
0135,vap_asian,90,204,114,158,113
0135,vap_black,88,182,94,144,107
0135,vap_hisp,70,138,68,111,84
0135,vap_nhpi,1,3,2,2,1
0135,vap_other,5,11,6,9,6
0135,vap_two,26,82,56,60,37
0135,vap_white,1311,1369,58,1346,1323
0136,pop,1507,1561,54,1539,1518
0136,pop_aian,1,4,3,3,2
0136,pop_asian,55,60,5,58,56
0136,pop_black,62,94,32,81,68
0136,pop_hisp,55,119,64,93,68
0136,pop_nhpi,0,3,3,2,1
0136,pop_other,3,4,1,4,3
0136,pop_two,46,72,26,62,51
0136,pop_white,1285,1205,-80,1237,1269
0136,vap,1450,1444,-6,1446,1449
0136,vap_aian,1,3,2,2,1
0136,vap_asian,54,58,4,56,55
0136,vap_black,57,85,28,74,63
0136,vap_hisp,49,110,61,86,61
0136,vap_nhpi,0,3,3,2,1
0136,vap_other,3,1,-2,2,3
0136,vap_two,33,49,16,43,36
0136,vap_white,1253,1135,-118,1182,1229
0137,pop,1246,1383,137,1328,1273
0137,pop_aian,5,5,0,5,5
0137,pop_asian,33,24,-9,28,31
0137,pop_black,95,81,-14,87,92
0137,pop_hisp,75,88,13,83,78
0137,pop_nhpi,0,0,0,0,0
0137,pop_other,11,57,46,39,20
0137,pop_two,31,46,15,40,34
0137,pop_white,996,1082,86,1048,1013
0137,vap,1158,1314,156,1252,1189
0137,vap_aian,4,5,1,5,4
0137,vap_asian,33,24,-9,28,31
0137,vap_black,85,72,-13,77,82
0137,vap_hisp,61,78,17,71,64
0137,vap_nhpi,0,0,0,0,0
0137,vap_other,8,57,49,37,18
0137,vap_two,22,30,8,27,24
0137,vap_white,945,1048,103,1007,966
0138,pop,3233,3059,-174,3129,3198
0138,pop_aian,21,9,-12,14,19
0138,pop_asian,35,32,-3,33,34
0138,pop_black,396,287,-109,331,374
0138,pop_hisp,347,295,-52,316,337
0138,pop_nhpi,1,1,0,1,1
0138,pop_other,9,21,12,16,11
0138,pop_two,114,164,50,144,124
0138,pop_white,2310,2250,-60,2274,2298
0138,vap,2854,2710,-144,2768,2825
0138,vap_aian,18,7,-11,11,16
0138,vap_asian,33,29,-4,31,32
0138,vap_black,290,220,-70,248,276
0138,vap_hisp,256,237,-19,245,252
0138,vap_nhpi,1,1,0,1,1
0138,vap_other,6,18,12,13,8
0138,vap_two,80,126,46,108,89
0138,vap_white,2170,2072,-98,2111,2150
0139,pop,2946,2482,-464,2668,2853
0139,pop_aian,12,11,-1,11,12
0139,pop_asian,18,30,12,25,20
0139,pop_black,1240,795,-445,973,1151
0139,pop_hisp,616,486,-130,538,590
0139,pop_nhpi,0,1,1,1,0
0139,pop_other,4,15,11,11,6
0139,pop_two,114,132,18,125,118
0139,pop_white,942,1012,70,984,956
0139,vap,2139,1981,-158,2044,2107
0139,vap_aian,11,10,-1,10,11
0139,vap_asian,15,21,6,19,16
0139,vap_black,798,581,-217,668,755
0139,vap_hisp,402,351,-51,371,392
0139,vap_nhpi,0,1,1,1,0
0139,vap_other,2,12,10,8,4
0139,vap_two,58,89,31,77,64
0139,vap_white,853,916,63,891,866
0140,pop,1088,965,-123,1014,1063
0140,pop_aian,7,0,-7,3,6
0140,pop_asian,1,1,0,1,1
0140,pop_black,812,657,-155,719,781
0140,pop_hisp,145,144,-1,144,145
0140,pop_nhpi,0,0,0,0,0
0140,pop_other,0,7,7,4,1
0140,pop_two,45,30,-15,36,42
0140,pop_white,78,126,48,107,88
0140,vap,719,688,-31,700,713
0140,vap_aian,4,0,-4,2,3
0140,vap_asian,1,1,0,1,1
0140,vap_black,528,451,-77,482,513
0140,vap_hisp,98,104,6,102,99
0140,vap_nhpi,0,0,0,0,0
0140,vap_other,0,4,4,2,1
0140,vap_two,18,19,1,19,18
0140,vap_white,70,109,39,93,78
0141,pop,1471,1301,-170,1369,1437
0141,pop_aian,5,0,-5,2,4
0141,pop_asian,2,12,10,8,4
0141,pop_black,1279,1012,-267,1119,1226
0141,pop_hisp,59,79,20,71,63
0141,pop_nhpi,1,1,0,1,1
0141,pop_other,1,13,12,8,3
0141,pop_two,45,62,17,55,48
0141,pop_white,79,122,43,105,88
0141,vap,957,942,-15,948,954
0141,vap_aian,3,0,-3,1,2
0141,vap_asian,2,5,3,4,3
0141,vap_black,828,751,-77,782,813
0141,vap_hisp,32,43,11,39,34
0141,vap_nhpi,1,1,0,1,1
0141,vap_other,1,5,4,3,2
0141,vap_two,22,36,14,30,25
0141,vap_white,68,101,33,88,75
0142,pop,1436,1361,-75,1391,1421
0142,pop_aian,13,5,-8,8,11
0142,pop_asian,10,5,-5,7,9
0142,pop_black,1284,1075,-209,1159,1242
0142,pop_hisp,51,82,31,70,57
0142,pop_nhpi,0,0,0,0,0
0142,pop_other,0,10,10,6,2
0142,pop_two,41,85,44,67,50
0142,pop_white,37,99,62,74,49
0142,vap,979,1001,22,992,983
0142,vap_aian,8,5,-3,6,7
0142,vap_asian,9,0,-9,4,7
0142,vap_black,878,799,-79,831,862
0142,vap_hisp,31,47,16,41,34
0142,vap_nhpi,0,0,0,0,0
0142,vap_other,0,4,4,2,1
0142,vap_two,19,54,35,40,26
0142,vap_white,34,92,58,69,46
0143,pop,1777,1254,-523,1463,1672
0143,pop_aian,3,4,1,4,3
0143,pop_asian,22,9,-13,14,19
0143,pop_black,1640,1078,-562,1303,1528
0143,pop_hisp,46,57,11,53,48
0143,pop_nhpi,0,0,0,0,0
0143,pop_other,1,12,11,8,3
0143,pop_two,45,52,7,49,46
0143,pop_white,20,42,22,33,24
0143,vap,1063,844,-219,932,1019
0143,vap_aian,3,4,1,4,3
0143,vap_asian,13,4,-9,8,11
0143,vap_black,984,732,-252,833,934
0143,vap_hisp,25,24,-1,24,25
0143,vap_nhpi,0,0,0,0,0
0143,vap_other,1,12,11,8,3
0143,vap_two,20,36,16,30,23
0143,vap_white,17,32,15,26,20
0144,pop,1104,889,-215,975,1061
0144,pop_aian,5,4,-1,4,5
0144,pop_asian,1,8,7,5,2
0144,pop_black,1028,798,-230,890,982
0144,pop_hisp,27,29,2,28,27
0144,pop_nhpi,0,0,0,0,0
0144,pop_other,0,7,7,4,1
0144,pop_two,23,17,-6,19,22
0144,pop_white,20,26,6,24,21
0144,vap,704,647,-57,670,693
0144,vap_aian,3,3,0,3,3
0144,vap_asian,1,7,6,5,2
0144,vap_black,657,586,-71,614,643
0144,vap_hisp,17,19,2,18,17
0144,vap_nhpi,0,0,0,0,0
0144,vap_other,0,2,2,1,0
0144,vap_two,11,9,-2,10,11
0144,vap_white,15,21,6,19,16
0145,pop,743,742,-1,742,743
0145,pop_aian,2,1,-1,1,2
0145,pop_asian,10,1,-9,5,8
0145,pop_black,701,622,-79,654,685
0145,pop_hisp,14,27,13,22,17
0145,pop_nhpi,0,0,0,0,0
0145,pop_other,0,1,1,1,0
0145,pop_two,5,34,29,22,11
0145,pop_white,11,56,45,38,20
0145,vap,485,488,3,487,486
0145,vap_aian,2,1,-1,1,2
0145,vap_asian,7,1,-6,3,6
0145,vap_black,454,415,-39,431,446
0145,vap_hisp,7,12,5,10,8
0145,vap_nhpi,0,0,0,0,0
0145,vap_other,0,1,1,1,0
0145,vap_two,4,14,10,10,6
0145,vap_white,11,44,33,31,18
0146,pop,717,493,-224,583,672
0146,pop_aian,3,0,-3,1,2
0146,pop_asian,0,1,1,1,0
0146,pop_black,681,447,-234,541,634
0146,pop_hisp,15,23,8,20,17
0146,pop_nhpi,0,0,0,0,0
0146,pop_other,0,1,1,1,0
0146,pop_two,16,15,-1,15,16
0146,pop_white,2,6,4,4,3
0146,vap,453,367,-86,401,436
0146,vap_aian,3,0,-3,1,2
0146,vap_asian,0,1,1,1,0
0146,vap_black,431,334,-97,373,412
0146,vap_hisp,8,13,5,11,9
0146,vap_nhpi,0,0,0,0,0
0146,vap_other,0,1,1,1,0
0146,vap_two,9,12,3,11,10
0146,vap_white,2,6,4,4,3
0147,pop,2646,2252,-394,2410,2567
0147,pop_aian,5,4,-1,4,5
0147,pop_asian,6,10,4,8,7
0147,pop_black,2516,2020,-496,2218,2417
0147,pop_hisp,53,64,11,60,55
0147,pop_nhpi,0,0,0,0,0
0147,pop_other,5,7,2,6,5
0147,pop_two,32,78,46,60,41
0147,pop_white,29,69,40,53,37
0147,vap,1606,1449,-157,1512,1575
0147,vap_aian,4,4,0,4,4
0147,vap_asian,3,5,2,4,3
0147,vap_black,1536,1308,-228,1399,1490
0147,vap_hisp,23,24,1,24,23
0147,vap_nhpi,0,0,0,0,0
0147,vap_other,1,3,2,2,1
0147,vap_two,21,43,22,34,25
0147,vap_white,18,62,44,44,27
0148,pop,1664,1532,-132,1585,1638
0148,pop_aian,2,3,1,3,2
0148,pop_asian,8,9,1,9,8
0148,pop_black,1536,1379,-157,1442,1505
0148,pop_hisp,70,72,2,71,70
0148,pop_nhpi,0,0,0,0,0
0148,pop_other,2,4,2,3,2
0148,pop_two,23,38,15,32,26
0148,pop_white,23,27,4,25,24
0148,vap,1063,1032,-31,1044,1057
0148,vap_aian,2,3,1,3,2
0148,vap_asian,8,8,0,8,8
0148,vap_black,988,922,-66,948,975
0148,vap_hisp,34,50,16,44,37
0148,vap_nhpi,0,0,0,0,0
0148,vap_other,2,4,2,3,2
0148,vap_two,8,27,19,19,12
0148,vap_white,21,18,-3,19,20
0149,pop,2403,1825,-578,2056,2287
0149,pop_aian,5,0,-5,2,4
0149,pop_asian,28,70,42,53,36
0149,pop_black,2192,1550,-642,1807,2064
0149,pop_hisp,70,103,33,90,77
0149,pop_nhpi,0,2,2,1,0
0149,pop_other,0,5,5,3,1
0149,pop_two,61,55,-6,57,60
0149,pop_white,47,40,-7,43,46
0149,vap,1505,1250,-255,1352,1454
0149,vap_aian,5,0,-5,2,4
0149,vap_asian,17,35,18,28,21
0149,vap_black,1377,1071,-306,1193,1316
0149,vap_hisp,36,70,34,56,43
0149,vap_nhpi,0,2,2,1,0
0149,vap_other,0,5,5,3,1
0149,vap_two,34,34,0,34,34
0149,vap_white,36,33,-3,34,35
0150,pop,1784,1862,78,1831,1800
0150,pop_aian,9,6,-3,7,8
0150,pop_asian,265,440,175,370,300
0150,pop_black,1333,1220,-113,1265,1310
0150,pop_hisp,66,83,17,76,69
0150,pop_nhpi,0,0,0,0,0
0150,pop_other,0,11,11,7,2
0150,pop_two,38,68,30,56,44
0150,pop_white,73,34,-39,50,65
0150,vap,1090,1130,40,1114,1098
0150,vap_aian,5,2,-3,3,4
0150,vap_asian,143,244,101,204,163
0150,vap_black,822,774,-48,793,812
0150,vap_hisp,40,40,0,40,40
0150,vap_nhpi,0,0,0,0,0
0150,vap_other,0,9,9,5,2
0150,vap_two,18,30,12,25,20
0150,vap_white,62,31,-31,43,56
0151,pop,1415,1137,-278,1248,1359
0151,pop_aian,3,1,-2,2,3
0151,pop_asian,1,13,12,8,3
0151,pop_black,1309,990,-319,1118,1245
0151,pop_hisp,34,51,17,44,37
0151,pop_nhpi,1,0,-1,0,1
0151,pop_other,0,4,4,2,1
0151,pop_two,10,32,22,23,14
0151,pop_white,57,46,-11,50,55
0151,vap,947,829,-118,876,923
0151,vap_aian,2,0,-2,1,2
0151,vap_asian,1,7,6,5,2
0151,vap_black,867,716,-151,776,837
0151,vap_hisp,15,34,19,26,19
0151,vap_nhpi,1,0,-1,0,1
0151,vap_other,0,4,4,2,1
0151,vap_two,7,24,17,17,10
0151,vap_white,54,44,-10,48,52
0152,pop,1433,1228,-205,1310,1392
0152,pop_aian,2,0,-2,1,2
0152,pop_asian,27,36,9,32,29
0152,pop_black,1308,1018,-290,1134,1250
0152,pop_hisp,63,116,53,95,74
0152,pop_nhpi,1,1,0,1,1
0152,pop_other,2,6,4,4,3
0152,pop_two,8,45,37,30,15
0152,pop_white,22,6,-16,12,19
0152,vap,870,793,-77,824,855
0152,vap_aian,2,0,-2,1,2
0152,vap_asian,11,24,13,19,14
0152,vap_black,794,657,-137,712,767
0152,vap_hisp,35,74,39,58,43
0152,vap_nhpi,1,1,0,1,1
0152,vap_other,2,6,4,4,3
0152,vap_two,6,27,21,19,10
0152,vap_white,19,4,-15,10,16
0153,pop,1824,1489,-335,1623,1757
0153,pop_aian,12,4,-8,7,10
0153,pop_asian,19,7,-12,12,17
0153,pop_black,1644,1290,-354,1432,1573
0153,pop_hisp,39,56,17,49,42
0153,pop_nhpi,0,0,0,0,0
0153,pop_other,0,13,13,8,3
0153,pop_two,21,63,42,46,29
0153,pop_white,89,56,-33,69,82
0153,vap,1158,1047,-111,1091,1136
0153,vap_aian,6,3,-3,4,5
0153,vap_asian,9,1,-8,4,7
0153,vap_black,1022,912,-110,956,1000
0153,vap_hisp,26,26,0,26,26
0153,vap_nhpi,0,0,0,0,0
0153,vap_other,0,9,9,5,2
0153,vap_two,12,44,32,31,18
0153,vap_white,83,52,-31,64,77
0154,pop,1711,1393,-318,1520,1647
0154,pop_aian,3,1,-2,2,3
0154,pop_asian,10,24,14,18,13
0154,pop_black,1571,1224,-347,1363,1502
0154,pop_hisp,46,51,5,49,47
0154,pop_nhpi,0,0,0,0,0
0154,pop_other,0,5,5,3,1
0154,pop_two,25,32,7,29,26
0154,pop_white,56,56,0,56,56
0154,vap,1040,930,-110,974,1018
0154,vap_aian,3,1,-2,2,3
0154,vap_asian,7,14,7,11,8
0154,vap_black,938,818,-120,866,914
0154,vap_hisp,24,32,8,29,26
0154,vap_nhpi,0,0,0,0,0
0154,vap_other,0,4,4,2,1
0154,vap_two,15,16,1,16,15
0154,vap_white,53,45,-8,48,51
0155,pop,1880,1773,-107,1816,1859
0155,pop_aian,3,7,4,5,4
0155,pop_asian,74,108,34,94,81
0155,pop_black,1686,1508,-178,1579,1650
0155,pop_hisp,59,45,-14,51,56
0155,pop_nhpi,0,2,2,1,0
0155,pop_other,4,9,5,7,5
0155,pop_two,25,60,35,46,32
0155,pop_white,29,34,5,32,30
0155,vap,1046,1080,34,1066,1053
0155,vap_aian,2,4,2,3,2
0155,vap_asian,31,69,38,54,39
0155,vap_black,941,900,-41,916,933
0155,vap_hisp,30,27,-3,28,29
0155,vap_nhpi,0,2,2,1,0
0155,vap_other,4,7,3,6,5
0155,vap_two,12,37,25,27,17
0155,vap_white,26,34,8,31,28
0156,pop,2078,2042,-36,2056,2071
0156,pop_aian,4,7,3,6,5
0156,pop_asian,51,80,29,68,57
0156,pop_black,1821,1725,-96,1763,1802
0156,pop_hisp,77,68,-9,72,75
0156,pop_nhpi,0,0,0,0,0
0156,pop_other,4,5,1,5,4
0156,pop_two,56,53,-3,54,55
0156,pop_white,65,104,39,88,73
0156,vap,1192,1263,71,1235,1206
0156,vap_aian,2,5,3,4,3
0156,vap_asian,26,50,24,40,31
0156,vap_black,1049,1059,10,1055,1051
0156,vap_hisp,36,38,2,37,36
0156,vap_nhpi,0,0,0,0,0
0156,vap_other,3,2,-1,2,3
0156,vap_two,22,31,9,27,24
0156,vap_white,54,78,24,68,59
0157,pop,1368,1167,-201,1247,1328
0157,pop_aian,9,3,-6,5,8
0157,pop_asian,53,45,-8,48,51
0157,pop_black,972,708,-264,814,919
0157,pop_hisp,50,78,28,67,56
0157,pop_nhpi,0,0,0,0,0
0157,pop_other,0,5,5,3,1
0157,pop_two,48,71,23,62,53
0157,pop_white,236,257,21,249,240
0157,vap,864,777,-87,812,847
0157,vap_aian,6,1,-5,3,5
0157,vap_asian,31,34,3,33,32
0157,vap_black,593,452,-141,508,565
0157,vap_hisp,24,47,23,38,29
0157,vap_nhpi,0,0,0,0,0
0157,vap_other,0,1,1,1,0
0157,vap_two,14,27,13,22,17
0157,vap_white,196,215,19,207,200
0158,pop,1243,1117,-126,1167,1218
0158,pop_aian,5,6,1,6,5
0158,pop_asian,58,24,-34,38,51
0158,pop_black,967,873,-94,911,948
0158,pop_hisp,51,75,24,65,56
0158,pop_nhpi,0,1,1,1,0
0158,pop_other,5,7,2,6,5
0158,pop_two,49,31,-18,38,45
0158,pop_white,108,100,-8,103,106
0158,vap,744,686,-58,709,732
0158,vap_aian,2,6,4,4,3
0158,vap_asian,33,9,-24,19,28
0158,vap_black,580,545,-35,559,573
0158,vap_hisp,27,31,4,29,28
0158,vap_nhpi,0,1,1,1,0
0158,vap_other,0,4,4,2,1
0158,vap_two,23,16,-7,19,22
0158,vap_white,79,74,-5,76,78
0159,pop,1203,1142,-61,1166,1191
0159,pop_aian,8,2,-6,4,7
0159,pop_asian,15,24,9,20,17
0159,pop_black,1005,889,-116,935,982
0159,pop_hisp,53,56,3,55,54
0159,pop_nhpi,0,0,0,0,0
0159,pop_other,1,2,1,2,1
0159,pop_two,29,54,25,44,34
0159,pop_white,92,115,23,106,97
0159,vap,717,738,21,730,721
0159,vap_aian,4,2,-2,3,4
0159,vap_asian,11,24,13,19,14
0159,vap_black,586,564,-22,573,582
0159,vap_hisp,23,30,7,27,24
0159,vap_nhpi,0,0,0,0,0
0159,vap_other,1,2,1,2,1
0159,vap_two,13,23,10,19,15
0159,vap_white,79,93,14,87,82
0160,pop,1526,1513,-13,1518,1523
0160,pop_aian,3,0,-3,1,2
0160,pop_asian,30,16,-14,22,27
0160,pop_black,1328,1277,-51,1297,1318
0160,pop_hisp,35,91,56,69,46
0160,pop_nhpi,0,0,0,0,0
0160,pop_other,2,8,6,6,3
0160,pop_two,44,40,-4,42,43
0160,pop_white,84,81,-3,82,83
0160,vap,962,944,-18,951,958
0160,vap_aian,1,0,-1,0,1
0160,vap_asian,18,16,-2,17,18
0160,vap_black,832,817,-15,823,829
0160,vap_hisp,19,34,15,28,22
0160,vap_nhpi,0,0,0,0,0
0160,vap_other,2,5,3,4,3
0160,vap_two,14,16,2,15,14
0160,vap_white,76,56,-20,64,72
0161,pop,574,477,-97,516,555
0161,pop_aian,2,1,-1,1,2
0161,pop_asian,0,5,5,3,1
0161,pop_black,499,382,-117,429,476
0161,pop_hisp,26,30,4,28,27
0161,pop_nhpi,0,0,0,0,0
0161,pop_other,0,0,0,0,0
0161,pop_two,5,15,10,11,7
0161,pop_white,42,44,2,43,42
0161,vap,347,305,-42,322,339
0161,vap_aian,2,1,-1,1,2
0161,vap_asian,0,5,5,3,1
0161,vap_black,302,246,-56,268,291
0161,vap_hisp,11,15,4,13,12
0161,vap_nhpi,0,0,0,0,0
0161,vap_other,0,0,0,0,0
0161,vap_two,1,2,1,2,1
0161,vap_white,31,36,5,34,32
0162,pop,1049,1043,-6,1045,1048
0162,pop_aian,0,7,7,4,1
0162,pop_asian,1,33,32,20,7
0162,pop_black,879,821,-58,844,867
0162,pop_hisp,49,58,9,54,51
0162,pop_nhpi,2,0,-2,1,2
0162,pop_other,4,1,-3,2,3
0162,pop_two,34,32,-2,33,34
0162,pop_white,80,91,11,87,82
0162,vap,695,683,-12,688,693
0162,vap_aian,0,0,0,0,0
0162,vap_asian,1,21,20,13,5
0162,vap_black,566,515,-51,535,556
0162,vap_hisp,37,43,6,41,38
0162,vap_nhpi,2,0,-2,1,2
0162,vap_other,1,1,0,1,1
0162,vap_two,12,22,10,18,14
0162,vap_white,76,81,5,79,77
0163,pop,1819,1511,-308,1634,1757
0163,pop_aian,6,3,-3,4,5
0163,pop_asian,49,30,-19,38,45
0163,pop_black,1440,1171,-269,1279,1386
0163,pop_hisp,72,92,20,84,76
0163,pop_nhpi,0,0,0,0,0
0163,pop_other,1,15,14,9,4
0163,pop_two,37,67,30,55,43
0163,pop_white,214,133,-81,165,198
0163,vap,1205,1028,-177,1099,1170
0163,vap_aian,4,3,-1,3,4
0163,vap_asian,35,24,-11,28,33
0163,vap_black,908,792,-116,838,885
0163,vap_hisp,43,55,12,50,45
0163,vap_nhpi,0,0,0,0,0
0163,vap_other,1,7,6,5,2
0163,vap_two,18,26,8,23,20
0163,vap_white,196,121,-75,151,181
0164,pop,1775,1748,-27,1759,1770
0164,pop_aian,11,4,-7,7,10
0164,pop_asian,55,34,-21,42,51
0164,pop_black,1012,1073,61,1049,1024
0164,pop_hisp,100,128,28,117,106
0164,pop_nhpi,0,0,0,0,0
0164,pop_other,2,17,15,11,5
0164,pop_two,70,66,-4,68,69
0164,pop_white,525,426,-99,466,505
0164,vap,1292,1303,11,1299,1294
0164,vap_aian,3,3,0,3,3
0164,vap_asian,35,29,-6,31,34
0164,vap_black,702,770,68,743,716
0164,vap_hisp,63,86,23,77,68
0164,vap_nhpi,0,0,0,0,0
0164,vap_other,1,10,9,6,3
0164,vap_two,33,37,4,35,34
0164,vap_white,455,368,-87,403,438
0165,pop,1852,1790,-62,1815,1840
0165,pop_aian,15,8,-7,11,14
0165,pop_asian,57,100,43,83,66
0165,pop_black,944,894,-50,914,934
0165,pop_hisp,119,180,61,156,131
0165,pop_nhpi,0,0,0,0,0
0165,pop_other,2,6,4,4,3
0165,pop_two,61,113,52,92,71
0165,pop_white,654,489,-165,555,621
0165,vap,1296,1255,-41,1271,1288
0165,vap_aian,10,6,-4,8,9
0165,vap_asian,36,75,39,59,44
0165,vap_black,577,582,5,580,578
0165,vap_hisp,80,101,21,93,84
0165,vap_nhpi,0,0,0,0,0
0165,vap_other,2,5,3,4,3
0165,vap_two,29,58,29,46,35
0165,vap_white,562,428,-134,482,535
0166,pop,704,634,-70,662,690
0166,pop_aian,3,1,-2,2,3
0166,pop_asian,12,13,1,13,12
0166,pop_black,348,259,-89,295,330
0166,pop_hisp,44,53,9,49,46
0166,pop_nhpi,0,0,0,0,0
0166,pop_other,1,4,3,3,2
0166,pop_two,25,28,3,27,26
0166,pop_white,271,276,5,274,272
0166,vap,501,497,-4,499,500
0166,vap_aian,3,1,-2,2,3
0166,vap_asian,11,11,0,11,11
0166,vap_black,212,193,-19,201,208
0166,vap_hisp,31,40,9,36,33
0166,vap_nhpi,0,0,0,0,0
0166,vap_other,0,0,0,0,0
0166,vap_two,8,15,7,12,9
0166,vap_white,236,237,1,237,236
0167,pop,1395,1282,-113,1327,1372
0167,pop_aian,7,5,-2,6,7
0167,pop_asian,22,25,3,24,23
0167,pop_black,363,314,-49,334,353
0167,pop_hisp,78,94,16,88,81
0167,pop_nhpi,0,0,0,0,0
0167,pop_other,10,0,-10,4,8
0167,pop_two,46,78,32,65,52
0167,pop_white,869,766,-103,807,848
0167,vap,1042,1051,9,1047,1044
0167,vap_aian,7,5,-2,6,7
0167,vap_asian,12,23,11,19,14
0167,vap_black,225,227,2,226,225
0167,vap_hisp,50,60,10,56,52
0167,vap_nhpi,0,0,0,0,0
0167,vap_other,5,0,-5,2,4
0167,vap_two,22,40,18,33,26
0167,vap_white,721,696,-25,706,716
0168,pop,2450,2360,-90,2396,2432
0168,pop_aian,12,9,-3,10,11
0168,pop_asian,56,42,-14,48,53
0168,pop_black,363,327,-36,341,356
0168,pop_hisp,155,170,15,164,158
0168,pop_nhpi,0,0,0,0,0
0168,pop_other,0,11,11,7,2
0168,pop_two,86,114,28,103,92
0168,pop_white,1778,1687,-91,1723,1760
0168,vap,1848,1841,-7,1844,1847
0168,vap_aian,11,6,-5,8,10
0168,vap_asian,40,37,-3,38,39
0168,vap_black,225,220,-5,222,224
0168,vap_hisp,85,123,38,108,93
0168,vap_nhpi,0,0,0,0,0
0168,vap_other,0,8,8,5,2
0168,vap_two,30,52,22,43,34
0168,vap_white,1457,1395,-62,1420,1445
0169,pop,1866,1686,-180,1758,1830
0169,pop_aian,5,4,-1,4,5
0169,pop_asian,240,258,18,251,244
0169,pop_black,1387,1171,-216,1257,1344
0169,pop_hisp,91,124,33,111,98
0169,pop_nhpi,0,1,1,1,0
0169,pop_other,0,7,7,4,1
0169,pop_two,52,57,5,55,53
0169,pop_white,91,64,-27,75,86
0169,vap,1025,1058,33,1045,1032
0169,vap_aian,3,1,-2,2,3
0169,vap_asian,129,144,15,138,132
0169,vap_black,746,734,-12,739,744
0169,vap_hisp,52,86,34,72,59
0169,vap_nhpi,0,1,1,1,0
0169,vap_other,0,7,7,4,1
0169,vap_two,20,31,11,27,22
0169,vap_white,75,54,-21,62,71
0170,pop,1605,1511,-94,1549,1586
0170,pop_aian,1,10,9,6,3
0170,pop_asian,708,617,-91,653,690
0170,pop_black,765,730,-35,744,758
0170,pop_hisp,24,66,42,49,32
0170,pop_nhpi,0,1,1,1,0
0170,pop_other,5,11,6,9,6
0170,pop_two,35,38,3,37,36
0170,pop_white,67,38,-29,50,61
0170,vap,898,922,24,912,903
0170,vap_aian,0,6,6,4,1
0170,vap_asian,361,376,15,370,364
0170,vap_black,440,459,19,451,444
0170,vap_hisp,15,30,15,24,18
0170,vap_nhpi,0,1,1,1,0
0170,vap_other,3,0,-3,1,2
0170,vap_two,18,12,-6,14,17
0170,vap_white,61,38,-23,47,56
0171,pop,1018,908,-110,952,996
0171,pop_aian,5,4,-1,4,5
0171,pop_asian,656,503,-153,564,625
0171,pop_black,277,300,23,291,282
0171,pop_hisp,44,60,16,54,47
0171,pop_nhpi,0,0,0,0,0
0171,pop_other,0,3,3,2,1
0171,pop_two,17,22,5,20,18
0171,pop_white,19,16,-3,17,18
0171,vap,559,559,0,559,559
0171,vap_aian,3,1,-2,2,3
0171,vap_asian,349,310,-39,326,341
0171,vap_black,155,192,37,177,162
0171,vap_hisp,28,36,8,33,30
0171,vap_nhpi,0,0,0,0,0
0171,vap_other,0,0,0,0,0
0171,vap_two,6,8,2,7,6
0171,vap_white,18,12,-6,14,17
0172,pop,1541,1308,-233,1401,1494
0172,pop_aian,5,3,-2,4,5
0172,pop_asian,170,170,0,170,170
0172,pop_black,1087,911,-176,981,1052
0172,pop_hisp,154,128,-26,138,149
0172,pop_nhpi,0,0,0,0,0
0172,pop_other,5,7,2,6,5
0172,pop_two,61,59,-2,60,61
0172,pop_white,59,30,-29,42,53
0172,vap,940,813,-127,864,915
0172,vap_aian,3,2,-1,2,3
0172,vap_asian,119,124,5,122,120
0172,vap_black,644,550,-94,588,625
0172,vap_hisp,91,76,-15,82,88
0172,vap_nhpi,0,0,0,0,0
0172,vap_other,1,1,0,1,1
0172,vap_two,24,34,10,30,26
0172,vap_white,58,26,-32,39,52
0173,pop,1606,1410,-196,1488,1567
0173,pop_aian,2,3,1,3,2
0173,pop_asian,89,139,50,119,99
0173,pop_black,1322,1030,-292,1147,1264
0173,pop_hisp,97,155,58,132,109
0173,pop_nhpi,0,0,0,0,0
0173,pop_other,3,8,5,6,4
0173,pop_two,45,53,8,50,47
0173,pop_white,48,22,-26,32,43
0173,vap,1082,933,-149,993,1052
0173,vap_aian,1,3,2,2,1
0173,vap_asian,64,79,15,73,67
0173,vap_black,900,699,-201,779,860
0173,vap_hisp,63,100,37,85,70
0173,vap_nhpi,0,0,0,0,0
0173,vap_other,2,7,5,5,3
0173,vap_two,17,29,12,24,19
0173,vap_white,35,16,-19,24,31
0174,pop,2318,2063,-255,2165,2267
0174,pop_aian,3,2,-1,2,3
0174,pop_asian,133,152,19,144,137
0174,pop_black,2009,1706,-303,1827,1948
0174,pop_hisp,52,85,33,72,59
0174,pop_nhpi,0,0,0,0,0
0174,pop_other,4,14,10,10,6
0174,pop_two,55,59,4,57,56
0174,pop_white,62,45,-17,52,59
0174,vap,1486,1343,-143,1400,1457
0174,vap_aian,0,2,2,1,0
0174,vap_asian,81,106,25,96,86
0174,vap_black,1296,1100,-196,1178,1257
0174,vap_hisp,29,59,30,47,35
0174,vap_nhpi,0,0,0,0,0
0174,vap_other,1,7,6,5,2
0174,vap_two,24,34,10,30,26
0174,vap_white,55,35,-20,43,51
0175,pop,1002,1241,239,1145,1050
0175,pop_aian,2,2,0,2,2
0175,pop_asian,11,10,-1,10,11
0175,pop_black,716,836,120,788,740
0175,pop_hisp,23,102,79,70,39
0175,pop_nhpi,0,1,1,1,0
0175,pop_other,1,12,11,8,3
0175,pop_two,10,53,43,36,19
0175,pop_white,239,225,-14,231,236
0175,vap,726,925,199,845,766
0175,vap_aian,2,2,0,2,2
0175,vap_asian,11,10,-1,10,11
0175,vap_black,472,595,123,546,497
0175,vap_hisp,18,67,49,47,28
0175,vap_nhpi,0,0,0,0,0
0175,vap_other,1,12,11,8,3
0175,vap_two,6,35,29,23,12
0175,vap_white,216,204,-12,209,214
0176,pop,1763,1938,175,1868,1798
0176,pop_aian,7,5,-2,6,7
0176,pop_asian,7,16,9,12,9
0176,pop_black,1506,1629,123,1580,1531
0176,pop_hisp,105,92,-13,97,102
0176,pop_nhpi,0,0,0,0,0
0176,pop_other,1,4,3,3,2
0176,pop_two,16,71,55,49,27
0176,pop_white,121,121,0,121,121
0176,vap,1187,1262,75,1232,1202
0176,vap_aian,5,5,0,5,5
0176,vap_asian,6,16,10,12,8
0176,vap_black,993,1030,37,1015,1000
0176,vap_hisp,61,57,-4,59,60
0176,vap_nhpi,0,0,0,0,0
0176,vap_other,1,4,3,3,2
0176,vap_two,10,44,34,30,17
0176,vap_white,111,106,-5,108,110
0177,pop,2840,3384,544,3166,2949
0177,pop_aian,12,10,-2,11,12
0177,pop_asian,75,74,-1,74,75
0177,pop_black,697,623,-74,653,682
0177,pop_hisp,256,349,93,312,275
0177,pop_nhpi,0,1,1,1,0
0177,pop_other,5,3,-2,4,5
0177,pop_two,65,160,95,122,84
0177,pop_white,1730,2164,434,1990,1817
0177,vap,2364,2958,594,2720,2483
0177,vap_aian,9,6,-3,7,8
0177,vap_asian,66,68,2,67,66
0177,vap_black,475,450,-25,460,470
0177,vap_hisp,177,267,90,231,195
0177,vap_nhpi,0,0,0,0,0
0177,vap_other,2,3,1,3,2
0177,vap_two,33,110,77,79,48
0177,vap_white,1602,2054,452,1873,1692
0178,pop,2350,2721,371,2573,2424
0178,pop_aian,14,8,-6,10,13
0178,pop_asian,56,89,33,76,63
0178,pop_black,234,235,1,235,234
0178,pop_hisp,126,171,45,153,135
0178,pop_nhpi,0,2,2,1,0
0178,pop_other,8,4,-4,6,7
0178,pop_two,58,145,87,110,75
0178,pop_white,1854,2067,213,1982,1897
0178,vap,2215,2599,384,2445,2292
0178,vap_aian,13,8,-5,10,12
0178,vap_asian,54,82,28,71,60
0178,vap_black,217,220,3,219,218
0178,vap_hisp,107,154,47,135,116
0178,vap_nhpi,0,2,2,1,0
0178,vap_other,5,2,-3,3,4
0178,vap_two,40,132,92,95,58
0178,vap_white,1779,1999,220,1911,1823
0179,pop,2522,2469,-53,2490,2511
0179,pop_aian,8,1,-7,4,7
0179,pop_asian,64,90,26,80,69
0179,pop_black,321,341,20,333,325
0179,pop_hisp,116,162,46,144,125
0179,pop_nhpi,5,0,-5,2,4
0179,pop_other,6,18,12,13,8
0179,pop_two,52,94,42,77,60
0179,pop_white,1950,1763,-187,1838,1913
0179,vap,2406,2376,-30,2388,2400
0179,vap_aian,8,1,-7,4,7
0179,vap_asian,57,90,33,77,64
0179,vap_black,306,335,29,323,312
0179,vap_hisp,101,144,43,127,110
0179,vap_nhpi,5,0,-5,2,4
0179,vap_other,6,15,9,11,8
0179,vap_two,41,86,45,68,50
0179,vap_white,1882,1705,-177,1776,1847
0180,pop,1619,2160,541,1944,1727
0180,pop_aian,2,0,-2,1,2
0180,pop_asian,74,95,21,87,78
0180,pop_black,118,139,21,131,122
0180,pop_hisp,59,142,83,109,76
0180,pop_nhpi,0,0,0,0,0
0180,pop_other,2,40,38,25,10
0180,pop_two,27,65,38,50,35
0180,pop_white,1338,1679,341,1543,1406
0180,vap,1559,2052,493,1855,1658
0180,vap_aian,1,0,-1,0,1
0180,vap_asian,73,89,16,83,76
0180,vap_black,117,135,18,128,121
0180,vap_hisp,52,128,76,98,67
0180,vap_nhpi,0,0,0,0,0
0180,vap_other,2,34,32,21,8
0180,vap_two,19,58,39,42,27
0180,vap_white,1296,1608,312,1483,1358
0181,pop,2172,2446,274,2336,2227
0181,pop_aian,4,2,-2,3,4
0181,pop_asian,151,125,-26,135,146
0181,pop_black,104,112,8,109,106
0181,pop_hisp,66,92,26,82,71
0181,pop_nhpi,2,0,-2,1,2
0181,pop_other,1,14,13,9,4
0181,pop_two,24,66,42,49,32
0181,pop_white,1820,2035,215,1949,1863
0181,vap,2129,2385,256,2283,2180
0181,vap_aian,4,1,-3,2,3
0181,vap_asian,143,118,-25,128,138
0181,vap_black,97,109,12,104,99
0181,vap_hisp,61,74,13,69,64
0181,vap_nhpi,2,0,-2,1,2
0181,vap_other,1,14,13,9,4
0181,vap_two,21,58,37,43,28
0181,vap_white,1800,2011,211,1927,1842
0182,pop,2488,2618,130,2566,2514
0182,pop_aian,12,12,0,12,12
0182,pop_asian,105,136,31,124,111
0182,pop_black,201,219,18,212,205
0182,pop_hisp,105,174,69,146,119
0182,pop_nhpi,1,0,-1,0,1
0182,pop_other,0,14,14,8,3
0182,pop_two,40,109,69,81,54
0182,pop_white,2024,1954,-70,1982,2010
0182,vap,2428,2560,132,2507,2454
0182,vap_aian,12,12,0,12,12
0182,vap_asian,100,135,35,121,107
0182,vap_black,195,210,15,204,198
0182,vap_hisp,97,167,70,139,111
0182,vap_nhpi,1,0,-1,0,1
0182,vap_other,0,12,12,7,2
0182,vap_two,39,104,65,78,52
0182,vap_white,1984,1920,-64,1946,1971
0183,pop,2785,4012,1227,3521,3030
0183,pop_aian,16,0,-16,6,13
0183,pop_asian,121,167,46,149,130
0183,pop_black,165,263,98,224,185
0183,pop_hisp,146,294,148,235,176
0183,pop_nhpi,5,0,-5,2,4
0183,pop_other,2,8,6,6,3
0183,pop_two,50,147,97,108,69
0183,pop_white,2280,3133,853,2792,2451
0183,vap,2656,3852,1196,3374,2895
0183,vap_aian,14,0,-14,6,11
0183,vap_asian,112,165,53,144,123
0183,vap_black,146,248,102,207,166
0183,vap_hisp,126,256,130,204,152
0183,vap_nhpi,5,0,-5,2,4
0183,vap_other,2,5,3,4,3
0183,vap_two,42,127,85,93,59
0183,vap_white,2209,3051,842,2714,2377
0184,pop,2646,2782,136,2728,2673
0184,pop_aian,16,8,-8,11,14
0184,pop_asian,92,137,45,119,101
0184,pop_black,274,313,39,297,282
0184,pop_hisp,93,205,112,160,115
0184,pop_nhpi,0,0,0,0,0
0184,pop_other,1,45,44,27,10
0184,pop_two,45,91,46,73,54
0184,pop_white,2125,1983,-142,2040,2097
0184,vap,2593,2736,143,2679,2622
0184,vap_aian,15,8,-7,11,14
0184,vap_asian,87,133,46,115,96
0184,vap_black,265,303,38,288,273
0184,vap_hisp,90,194,104,152,111
0184,vap_nhpi,0,0,0,0,0
0184,vap_other,1,45,44,27,10
0184,vap_two,40,85,45,67,49
0184,vap_white,2095,1968,-127,2019,2070
0185,pop,3810,4078,268,3971,3864
0185,pop_aian,7,7,0,7,7
0185,pop_asian,377,428,51,408,387
0185,pop_black,119,159,40,143,127
0185,pop_hisp,156,233,77,202,171
0185,pop_nhpi,1,1,0,1,1
0185,pop_other,4,33,29,21,10
0185,pop_two,64,118,54,96,75
0185,pop_white,3082,3099,17,3092,3085
0185,vap,3733,3981,248,3882,3783
0185,vap_aian,7,3,-4,5,6
0185,vap_asian,355,397,42,380,363
0185,vap_black,112,158,46,140,121
0185,vap_hisp,143,220,77,189,158
0185,vap_nhpi,1,1,0,1,1
0185,vap_other,3,29,26,19,8
0185,vap_two,61,111,50,91,71
0185,vap_white,3051,3062,11,3058,3053
0186,pop,2647,4014,1367,3467,2920
0186,pop_aian,4,13,9,9,6
0186,pop_asian,99,187,88,152,117
0186,pop_black,154,198,44,180,163
0186,pop_hisp,90,244,154,182,121
0186,pop_nhpi,0,1,1,1,0
0186,pop_other,2,12,10,8,4
0186,pop_two,36,141,105,99,57
0186,pop_white,2263,3218,955,2836,2454
0186,vap,2583,3877,1294,3359,2842
0186,vap_aian,3,9,6,7,4
0186,vap_asian,97,180,83,147,114
0186,vap_black,137,182,45,164,146
0186,vap_hisp,85,218,133,165,112
0186,vap_nhpi,0,0,0,0,0
0186,vap_other,2,12,10,8,4
0186,vap_two,35,125,90,89,53
0186,vap_white,2224,3151,927,2780,2409
0187,pop,1006,1655,649,1395,1136
0187,pop_aian,6,7,1,7,6
0187,pop_asian,33,80,47,61,42
0187,pop_black,194,223,29,211,200
0187,pop_hisp,75,151,76,121,90
0187,pop_nhpi,0,2,2,1,0
0187,pop_other,1,7,6,5,2
0187,pop_two,14,83,69,55,28
0187,pop_white,683,1102,419,934,767
0187,vap,966,1562,596,1324,1085
0187,vap_aian,6,6,0,6,6
0187,vap_asian,30,77,47,58,39
0187,vap_black,176,171,-5,173,175
0187,vap_hisp,68,139,71,111,82
0187,vap_nhpi,0,2,2,1,0
0187,vap_other,1,6,5,4,2
0187,vap_two,12,68,56,46,23
0187,vap_white,673,1093,420,925,757
0188,pop,2776,2083,-693,2360,2637
0188,pop_aian,25,13,-12,18,23
0188,pop_asian,52,84,32,71,58
0188,pop_black,1324,722,-602,963,1204
0188,pop_hisp,131,143,12,138,133
0188,pop_nhpi,5,0,-5,2,4
0188,pop_other,2,21,19,13,6
0188,pop_two,37,66,29,54,43
0188,pop_white,1200,1034,-166,1100,1167
0188,vap,2719,2020,-699,2300,2579
0188,vap_aian,23,13,-10,17,21
0188,vap_asian,49,79,30,67,55
0188,vap_black,1302,699,-603,940,1181
0188,vap_hisp,127,135,8,132,129
0188,vap_nhpi,2,0,-2,1,2
0188,vap_other,2,21,19,13,6
0188,vap_two,36,56,20,48,40
0188,vap_white,1178,1017,-161,1081,1146
0189,pop,1117,2019,902,1658,1297
0189,pop_aian,3,14,11,10,5
0189,pop_asian,38,111,73,82,53
0189,pop_black,766,805,39,789,774
0189,pop_hisp,46,182,136,128,73
0189,pop_nhpi,0,0,0,0,0
0189,pop_other,0,5,5,3,1
0189,pop_two,19,54,35,40,26
0189,pop_white,244,848,604,606,365
0189,vap,925,1766,841,1430,1093
0189,vap_aian,3,14,11,10,5
0189,vap_asian,29,95,66,69,42
0189,vap_black,612,645,33,632,619
0189,vap_hisp,33,153,120,105,57
0189,vap_nhpi,0,0,0,0,0
0189,vap_other,0,4,4,2,1
0189,vap_two,11,40,29,28,17
0189,vap_white,236,815,579,583,352
0190,pop,3130,3218,88,3183,3148
0190,pop_aian,8,8,0,8,8
0190,pop_asian,226,281,55,259,237
0190,pop_black,258,256,-2,257,258
0190,pop_hisp,148,358,210,274,190
0190,pop_nhpi,1,0,-1,0,1
0190,pop_other,1,9,8,6,3
0190,pop_two,21,108,87,73,38
0190,pop_white,2465,2198,-267,2305,2412
0190,vap,3113,3124,11,3120,3115
0190,vap_aian,8,7,-1,7,8
0190,vap_asian,224,265,41,249,232
0190,vap_black,251,235,-16,241,248
0190,vap_hisp,147,332,185,258,184
0190,vap_nhpi,1,0,-1,0,1
0190,vap_other,1,7,6,5,2
0190,vap_two,20,99,79,67,36
0190,vap_white,2459,2179,-280,2291,2403
0191,pop,2618,2754,136,2700,2645
0191,pop_aian,3,5,2,4,3
0191,pop_asian,205,234,29,222,211
0191,pop_black,118,136,18,129,122
0191,pop_hisp,134,286,152,225,164
0191,pop_nhpi,2,1,-1,1,2
0191,pop_other,0,13,13,8,3
0191,pop_two,19,98,79,66,35
0191,pop_white,2137,1981,-156,2043,2106
0191,vap,2602,2718,116,2672,2625
0191,vap_aian,3,2,-1,2,3
0191,vap_asian,196,234,38,219,204
0191,vap_black,118,129,11,125,120
0191,vap_hisp,134,278,144,220,163
0191,vap_nhpi,2,1,-1,1,2
0191,vap_other,0,10,10,6,2
0191,vap_two,19,96,77,65,34
0191,vap_white,2130,1968,-162,2033,2098
0192,pop,3253,2814,-439,2990,3165
0192,pop_aian,9,7,-2,8,9
0192,pop_asian,100,195,95,157,119
0192,pop_black,1028,853,-175,923,993
0192,pop_hisp,161,299,138,244,189
0192,pop_nhpi,2,6,4,4,3
0192,pop_other,8,19,11,15,10
0192,pop_two,39,91,52,70,49
0192,pop_white,1905,1344,-561,1568,1793
0192,vap,2797,2406,-391,2562,2719
0192,vap_aian,8,4,-4,6,7
0192,vap_asian,100,182,82,149,116
0192,vap_black,642,550,-92,587,624
0192,vap_hisp,140,254,114,208,163
0192,vap_nhpi,2,6,4,4,3
0192,vap_other,8,17,9,13,10
0192,vap_two,28,75,47,56,37
0192,vap_white,1869,1318,-551,1538,1759
0193,pop,2263,2010,-253,2111,2212
0193,pop_aian,5,5,0,5,5
0193,pop_asian,332,330,-2,331,332
0193,pop_black,1493,1155,-338,1290,1425
0193,pop_hisp,193,200,7,197,194
0193,pop_nhpi,0,0,0,0,0
0193,pop_other,10,3,-7,6,9
0193,pop_two,52,100,48,81,62
0193,pop_white,178,217,39,201,186
0193,vap,1450,1348,-102,1389,1430
0193,vap_aian,4,3,-1,3,4
0193,vap_asian,227,234,7,231,228
0193,vap_black,904,735,-169,803,870
0193,vap_hisp,119,123,4,121,120
0193,vap_nhpi,0,0,0,0,0
0193,vap_other,4,0,-4,2,3
0193,vap_two,27,55,28,44,33
0193,vap_white,165,198,33,185,172
0194,pop,1359,1373,14,1367,1362
0194,pop_aian,6,5,-1,5,6
0194,pop_asian,68,84,16,78,71
0194,pop_black,626,720,94,682,645
0194,pop_hisp,93,132,39,116,101
0194,pop_nhpi,3,1,-2,2,3
0194,pop_other,1,5,4,3,2
0194,pop_two,54,45,-9,49,52
0194,pop_white,508,381,-127,432,483
0194,vap,1202,1169,-33,1182,1195
0194,vap_aian,5,5,0,5,5
0194,vap_asian,63,78,15,72,66
0194,vap_black,520,578,58,555,532
0194,vap_hisp,73,117,44,99,82
0194,vap_nhpi,3,1,-2,2,3
0194,vap_other,1,5,4,3,2
0194,vap_two,37,28,-9,32,35
0194,vap_white,500,357,-143,414,471
0195,pop,1457,1426,-31,1438,1451
0195,pop_aian,14,5,-9,9,12
0195,pop_asian,24,34,10,30,26
0195,pop_black,1076,1022,-54,1044,1065
0195,pop_hisp,112,152,40,136,120
0195,pop_nhpi,0,0,0,0,0
0195,pop_other,3,6,3,5,4
0195,pop_two,43,37,-6,39,42
0195,pop_white,184,170,-14,176,181
0195,vap,1112,1154,42,1137,1120
0195,vap_aian,8,5,-3,6,7
0195,vap_asian,21,26,5,24,22
0195,vap_black,809,826,17,819,812
0195,vap_hisp,71,105,34,91,78
0195,vap_nhpi,0,0,0,0,0
0195,vap_other,3,6,3,5,4
0195,vap_two,22,26,4,24,23
0195,vap_white,177,160,-17,167,174
0196,pop,2456,2477,21,2469,2460
0196,pop_aian,14,18,4,16,15
0196,pop_asian,167,134,-33,147,160
0196,pop_black,1412,1352,-60,1376,1400
0196,pop_hisp,381,421,40,405,389
0196,pop_nhpi,4,4,0,4,4
0196,pop_other,2,22,20,14,6
0196,pop_two,80,123,43,106,89
0196,pop_white,396,403,7,400,397
0196,vap,1859,1893,34,1879,1866
0196,vap_aian,11,11,0,11,11
0196,vap_asian,136,109,-27,120,131
0196,vap_black,1014,990,-24,1000,1009
0196,vap_hisp,270,305,35,291,277
0196,vap_nhpi,3,2,-1,2,3
0196,vap_other,2,20,18,13,6
0196,vap_two,45,88,43,71,54
0196,vap_white,378,368,-10,372,376
0197,pop,1060,911,-149,971,1030
0197,pop_aian,4,8,4,6,5
0197,pop_asian,102,78,-24,88,97
0197,pop_black,689,501,-188,576,651
0197,pop_hisp,134,170,36,156,141
0197,pop_nhpi,0,0,0,0,0
0197,pop_other,2,1,-1,1,2
0197,pop_two,37,46,9,42,39
0197,pop_white,92,107,15,101,95
0197,vap,775,663,-112,708,753
0197,vap_aian,4,3,-1,3,4
0197,vap_asian,73,65,-8,68,71
0197,vap_black,492,367,-125,417,467
0197,vap_hisp,93,103,10,99,95
0197,vap_nhpi,0,0,0,0,0
0197,vap_other,0,1,1,1,0
0197,vap_two,27,24,-3,25,26
0197,vap_white,86,100,14,94,89
0198,pop,2218,2172,-46,2190,2209
0198,pop_aian,21,39,18,32,25
0198,pop_asian,4,24,20,16,8
0198,pop_black,1586,1290,-296,1408,1527
0198,pop_hisp,212,319,107,276,233
0198,pop_nhpi,0,2,2,1,0
0198,pop_other,5,9,4,7,6
0198,pop_two,54,110,56,88,65
0198,pop_white,336,379,43,362,345
0198,vap,1750,1775,25,1765,1755
0198,vap_aian,15,34,19,26,19
0198,vap_asian,3,22,19,14,7
0198,vap_black,1219,1068,-151,1128,1189
0198,vap_hisp,164,235,71,207,178
0198,vap_nhpi,0,2,2,1,0
0198,vap_other,3,9,6,7,4
0198,vap_two,35,64,29,52,41
0198,vap_white,311,341,30,329,317
0199,pop,1599,1171,-428,1342,1513
0199,pop_aian,19,15,-4,17,18
0199,pop_asian,13,12,-1,12,13
0199,pop_black,1134,804,-330,936,1068
0199,pop_hisp,125,71,-54,93,114
0199,pop_nhpi,0,1,1,1,0
0199,pop_other,0,1,1,1,0
0199,pop_two,37,50,13,45,40
0199,pop_white,271,217,-54,239,260
0199,vap,1349,939,-410,1103,1267
0199,vap_aian,17,6,-11,10,15
0199,vap_asian,11,6,-5,8,10
0199,vap_black,963,660,-303,781,902
0199,vap_hisp,86,45,-41,61,78
0199,vap_nhpi,0,0,0,0,0
0199,vap_other,0,1,1,1,0
0199,vap_two,20,28,8,25,22
0199,vap_white,252,193,-59,217,240
0200,pop,1019,945,-74,975,1004
0200,pop_aian,2,1,-1,1,2
0200,pop_asian,61,129,68,102,75
0200,pop_black,688,551,-137,606,661
0200,pop_hisp,61,74,13,69,64
0200,pop_nhpi,0,0,0,0,0
0200,pop_other,3,1,-2,2,3
0200,pop_two,27,40,13,35,30
0200,pop_white,177,149,-28,160,171
0200,vap,685,606,-79,638,669
0200,vap_aian,1,0,-1,0,1
0200,vap_asian,39,67,28,56,45
0200,vap_black,430,362,-68,389,416
0200,vap_hisp,41,30,-11,34,39
0200,vap_nhpi,0,0,0,0,0
0200,vap_other,3,0,-3,1,2
0200,vap_two,16,12,-4,14,15
0200,vap_white,155,135,-20,143,151
0201,pop,1122,1070,-52,1091,1112
0201,pop_aian,3,5,2,4,3
0201,pop_asian,85,145,60,121,97
0201,pop_black,769,533,-236,627,722
0201,pop_hisp,84,152,68,125,98
0201,pop_nhpi,0,0,0,0,0
0201,pop_other,4,6,2,5,4
0201,pop_two,44,60,16,54,47
0201,pop_white,133,169,36,155,140
0201,vap,800,806,6,804,801
0201,vap_aian,3,0,-3,1,2
0201,vap_asian,50,96,46,78,59
0201,vap_black,542,424,-118,471,518
0201,vap_hisp,51,102,51,82,61
0201,vap_nhpi,0,0,0,0,0
0201,vap_other,1,6,5,4,2
0201,vap_two,22,29,7,26,23
0201,vap_white,131,149,18,142,135
0202,pop,1669,1527,-142,1584,1641
0202,pop_aian,27,10,-17,17,24
0202,pop_asian,150,129,-21,137,146
0202,pop_black,634,541,-93,578,615
0202,pop_hisp,163,155,-8,158,161
0202,pop_nhpi,0,0,0,0,0
0202,pop_other,5,6,1,6,5
0202,pop_two,81,109,28,98,87
0202,pop_white,609,577,-32,590,603
0202,vap,1245,1204,-41,1220,1237
0202,vap_aian,21,10,-11,14,19
0202,vap_asian,97,87,-10,91,95
0202,vap_black,442,400,-42,417,434
0202,vap_hisp,100,109,9,105,102
0202,vap_nhpi,0,0,0,0,0
0202,vap_other,1,6,5,4,2
0202,vap_two,38,74,36,60,45
0202,vap_white,546,518,-28,529,540
0203,pop,1678,1673,-5,1675,1677
0203,pop_aian,5,10,5,8,6
0203,pop_asian,23,38,15,32,26
0203,pop_black,316,286,-30,298,310
0203,pop_hisp,101,149,48,130,111
0203,pop_nhpi,0,0,0,0,0
0203,pop_other,7,5,-2,6,7
0203,pop_two,57,86,29,74,63
0203,pop_white,1169,1099,-70,1127,1155
0203,vap,1323,1340,17,1333,1326
0203,vap_aian,4,10,6,8,5
0203,vap_asian,14,28,14,22,17
0203,vap_black,220,223,3,222,221
0203,vap_hisp,65,97,32,84,71
0203,vap_nhpi,0,0,0,0,0
0203,vap_other,5,5,0,5,5
0203,vap_two,30,49,19,41,34
0203,vap_white,985,928,-57,951,974
0204,pop,1360,1332,-28,1343,1354
0204,pop_aian,11,5,-6,7,10
0204,pop_asian,22,23,1,23,22
0204,pop_black,168,127,-41,143,160
0204,pop_hisp,67,107,40,91,75
0204,pop_nhpi,0,0,0,0,0
0204,pop_other,0,6,6,4,1
0204,pop_two,33,71,38,56,41
0204,pop_white,1059,993,-66,1019,1046
0204,vap,1077,1114,37,1099,1084
0204,vap_aian,5,4,-1,4,5
0204,vap_asian,15,23,8,20,17
0204,vap_black,116,95,-21,103,112
0204,vap_hisp,41,72,31,60,47
0204,vap_nhpi,0,0,0,0,0
0204,vap_other,0,5,5,3,1
0204,vap_two,15,46,31,34,21
0204,vap_white,885,869,-16,875,882
0205,pop,1310,1200,-110,1244,1288
0205,pop_aian,11,14,3,13,12
0205,pop_asian,43,33,-10,37,41
0205,pop_black,125,115,-10,119,123
0205,pop_hisp,72,91,19,83,76
0205,pop_nhpi,0,0,0,0,0
0205,pop_other,2,3,1,3,2
0205,pop_two,29,70,41,54,37
0205,pop_white,1028,874,-154,936,997
0205,vap,1095,1005,-90,1041,1077
0205,vap_aian,5,12,7,9,6
0205,vap_asian,34,31,-3,32,33
0205,vap_black,97,90,-7,93,96
0205,vap_hisp,56,51,-5,53,55
0205,vap_nhpi,0,0,0,0,0
0205,vap_other,2,3,1,3,2
0205,vap_two,13,32,19,24,17
0205,vap_white,888,786,-102,827,868
0206,pop,998,1005,7,1002,999
0206,pop_aian,4,5,1,5,4
0206,pop_asian,7,21,14,15,10
0206,pop_black,40,52,12,47,42
0206,pop_hisp,55,76,21,68,59
0206,pop_nhpi,1,0,-1,0,1
0206,pop_other,3,9,6,7,4
0206,pop_two,23,44,21,36,27
0206,pop_white,865,798,-67,825,852
0206,vap,774,819,45,801,783
0206,vap_aian,3,1,-2,2,3
0206,vap_asian,6,21,15,15,9
0206,vap_black,23,44,21,36,27
0206,vap_hisp,32,53,21,45,36
0206,vap_nhpi,1,0,-1,0,1
0206,vap_other,3,5,2,4,3
0206,vap_two,15,30,15,24,18
0206,vap_white,691,665,-26,675,686
0207,pop,1367,1344,-23,1353,1362
0207,pop_aian,9,13,4,11,10
0207,pop_asian,23,14,-9,18,21
0207,pop_black,83,126,43,109,92
0207,pop_hisp,137,202,65,176,150
0207,pop_nhpi,0,0,0,0,0
0207,pop_other,7,7,0,7,7
0207,pop_two,33,68,35,54,40
0207,pop_white,1075,914,-161,978,1043
0207,vap,1107,1115,8,1112,1109
0207,vap_aian,9,9,0,9,9
0207,vap_asian,22,10,-12,15,20
0207,vap_black,58,92,34,78,65
0207,vap_hisp,76,143,67,116,89
0207,vap_nhpi,0,0,0,0,0
0207,vap_other,4,3,-1,3,4
0207,vap_two,17,36,19,28,21
0207,vap_white,921,822,-99,862,901
0208,pop,1415,1505,90,1469,1433
0208,pop_aian,4,19,15,13,7
0208,pop_asian,19,34,15,28,22
0208,pop_black,84,167,83,134,101
0208,pop_hisp,118,164,46,146,127
0208,pop_nhpi,1,1,0,1,1
0208,pop_other,0,5,5,3,1
0208,pop_two,35,105,70,77,49
0208,pop_white,1154,1010,-144,1068,1125
0208,vap,1152,1195,43,1178,1161
0208,vap_aian,4,16,12,11,6
0208,vap_asian,15,28,13,23,18
0208,vap_black,53,108,55,86,64
0208,vap_hisp,74,108,34,94,81
0208,vap_nhpi,1,1,0,1,1
0208,vap_other,0,2,2,1,0
0208,vap_two,10,52,42,35,18
0208,vap_white,995,880,-115,926,972
0209,pop,1277,1395,118,1348,1301
0209,pop_aian,12,1,-11,5,10
0209,pop_asian,14,34,20,26,18
0209,pop_black,32,82,50,62,42
0209,pop_hisp,90,137,47,118,99
0209,pop_nhpi,0,0,0,0,0
0209,pop_other,2,17,15,11,5
0209,pop_two,18,52,34,38,25
0209,pop_white,1109,1072,-37,1087,1102
0209,vap,1064,1193,129,1141,1090
0209,vap_aian,8,0,-8,3,6
0209,vap_asian,7,34,27,23,12
0209,vap_black,21,63,42,46,29
0209,vap_hisp,52,96,44,78,61
0209,vap_nhpi,0,0,0,0,0
0209,vap_other,0,12,12,7,2
0209,vap_two,8,21,13,16,11
0209,vap_white,968,967,-1,967,968
0210,pop,1342,1513,171,1445,1376
0210,pop_aian,6,7,1,7,6
0210,pop_asian,54,63,9,59,56
0210,pop_black,53,61,8,58,55
0210,pop_hisp,63,125,62,100,75
0210,pop_nhpi,0,1,1,1,0
0210,pop_other,2,8,6,6,3
0210,pop_two,16,67,51,47,26
0210,pop_white,1148,1181,33,1168,1155
0210,vap,1215,1372,157,1309,1246
0210,vap_aian,4,7,3,6,5
0210,vap_asian,49,62,13,57,52
0210,vap_black,35,51,16,45,38
0210,vap_hisp,44,94,50,74,54
0210,vap_nhpi,0,1,1,1,0
0210,vap_other,0,8,8,5,2
0210,vap_two,11,48,37,33,18
0210,vap_white,1072,1101,29,1089,1078
0211,pop,1616,1539,-77,1570,1601
0211,pop_aian,6,11,5,9,7
0211,pop_asian,82,47,-35,61,75
0211,pop_black,130,210,80,178,146
0211,pop_hisp,189,201,12,196,191
0211,pop_nhpi,0,0,0,0,0
0211,pop_other,1,15,14,9,4
0211,pop_two,21,78,57,55,32
0211,pop_white,1187,977,-210,1061,1145
0211,vap,1241,1247,6,1245,1242
0211,vap_aian,5,6,1,6,5
0211,vap_asian,70,43,-27,54,65
0211,vap_black,76,136,60,112,88
0211,vap_hisp,108,130,22,121,112
0211,vap_nhpi,0,0,0,0,0
0211,vap_other,1,14,13,9,4
0211,vap_two,8,54,46,36,17
0211,vap_white,973,864,-109,908,951
0212,pop,1869,1891,22,1882,1873
0212,pop_aian,37,25,-12,30,35
0212,pop_asian,25,24,-1,24,25
0212,pop_black,118,124,6,122,119
0212,pop_hisp,305,590,285,476,362
0212,pop_nhpi,0,0,0,0,0
0212,pop_other,0,5,5,3,1
0212,pop_two,78,86,8,83,80
0212,pop_white,1306,1037,-269,1145,1252
0212,vap,1429,1421,-8,1424,1427
0212,vap_aian,26,21,-5,23,25
0212,vap_asian,19,18,-1,18,19
0212,vap_black,66,82,16,76,69
0212,vap_hisp,184,360,176,290,219
0212,vap_nhpi,0,0,0,0,0
0212,vap_other,0,5,5,3,1
0212,vap_two,34,50,16,44,37
0212,vap_white,1100,885,-215,971,1057
0213,pop,2228,1983,-245,2081,2179
0213,pop_aian,21,14,-7,17,20
0213,pop_asian,22,41,19,33,26
0213,pop_black,252,254,2,253,252
0213,pop_hisp,351,512,161,448,383
0213,pop_nhpi,1,0,-1,0,1
0213,pop_other,4,15,11,11,6
0213,pop_two,69,116,47,97,78
0213,pop_white,1508,1031,-477,1222,1413
0213,vap,1799,1522,-277,1633,1744
0213,vap_aian,18,12,-6,14,17
0213,vap_asian,17,33,16,27,20
0213,vap_black,217,170,-47,189,208
0213,vap_hisp,205,322,117,275,228
0213,vap_nhpi,1,0,-1,0,1
0213,vap_other,2,9,7,6,3
0213,vap_two,29,57,28,46,35
0213,vap_white,1310,919,-391,1075,1232
0214,pop,1066,1002,-64,1028,1053
0214,pop_aian,12,11,-1,11,12
0214,pop_asian,109,76,-33,89,102
0214,pop_black,286,294,8,291,288
0214,pop_hisp,166,190,24,180,171
0214,pop_nhpi,0,2,2,1,0
0214,pop_other,1,8,7,5,2
0214,pop_two,53,85,32,72,59
0214,pop_white,439,336,-103,377,418
0214,vap,767,765,-2,766,767
0214,vap_aian,10,7,-3,8,9
0214,vap_asian,60,52,-8,55,58
0214,vap_black,186,203,17,196,189
0214,vap_hisp,102,134,32,121,108
0214,vap_nhpi,0,2,2,1,0
0214,vap_other,1,5,4,3,2
0214,vap_two,20,44,24,34,25
0214,vap_white,388,318,-70,346,374
0215,pop,1592,1640,48,1621,1602
0215,pop_aian,32,17,-15,23,29
0215,pop_asian,81,85,4,83,82
0215,pop_black,164,228,64,202,177
0215,pop_hisp,924,1011,87,976,941
0215,pop_nhpi,0,1,1,1,0
0215,pop_other,3,5,2,4,3
0215,pop_two,42,67,25,57,47
0215,pop_white,346,226,-120,274,322
0215,vap,1035,1082,47,1063,1044
0215,vap_aian,28,15,-13,20,25
0215,vap_asian,52,66,14,60,55
0215,vap_black,92,129,37,114,99
0215,vap_hisp,539,642,103,601,560
0215,vap_nhpi,0,1,1,1,0
0215,vap_other,3,5,2,4,3
0215,vap_two,20,33,13,28,23
0215,vap_white,301,191,-110,235,279
0216,pop,1493,1300,-193,1377,1454
0216,pop_aian,27,10,-17,17,24
0216,pop_asian,61,77,16,71,64
0216,pop_black,94,84,-10,88,92
0216,pop_hisp,994,890,-104,932,973
0216,pop_nhpi,0,1,1,1,0
0216,pop_other,0,4,4,2,1
0216,pop_two,42,29,-13,34,39
0216,pop_white,275,205,-70,233,261
0216,vap,997,909,-88,944,979
0216,vap_aian,23,9,-14,15,20
0216,vap_asian,42,63,21,55,46
0216,vap_black,66,52,-14,58,63
0216,vap_hisp,602,595,-7,598,601
0216,vap_nhpi,0,0,0,0,0
0216,vap_other,0,2,2,1,0
0216,vap_two,18,15,-3,16,17
0216,vap_white,246,173,-73,202,231
0217,pop,2451,2401,-50,2421,2441
0217,pop_aian,22,6,-16,12,19
0217,pop_asian,111,121,10,117,113
0217,pop_black,58,53,-5,55,57
0217,pop_hisp,1681,1824,143,1767,1710
0217,pop_nhpi,0,0,0,0,0
0217,pop_other,0,17,17,10,3
0217,pop_two,28,39,11,35,30
0217,pop_white,551,341,-210,425,509
0217,vap,1618,1674,56,1652,1629
0217,vap_aian,18,5,-13,10,15
0217,vap_asian,81,97,16,91,84
0217,vap_black,43,40,-3,41,42
0217,vap_hisp,993,1202,209,1118,1035
0217,vap_nhpi,0,0,0,0,0
0217,vap_other,0,14,14,8,3
0217,vap_two,18,17,-1,17,18
0217,vap_white,465,299,-166,365,432
0218,pop,3350,3176,-174,3246,3315
0218,pop_aian,32,13,-19,21,28
0218,pop_asian,124,78,-46,96,115
0218,pop_black,87,80,-7,83,86
0218,pop_hisp,2495,2620,125,2570,2520
0218,pop_nhpi,0,2,2,1,0
0218,pop_other,0,7,7,4,1
0218,pop_two,44,42,-2,43,44
0218,pop_white,568,334,-234,428,521
0218,vap,2079,2095,16,2089,2082
0218,vap_aian,22,12,-10,16,20
0218,vap_asian,87,52,-35,66,80
0218,vap_black,52,45,-7,48,51
0218,vap_hisp,1413,1665,252,1564,1463
0218,vap_nhpi,0,2,2,1,0
0218,vap_other,0,6,6,4,1
0218,vap_two,17,23,6,21,18
0218,vap_white,488,290,-198,369,448
0219,pop,2306,1890,-416,2056,2223
0219,pop_aian,33,25,-8,28,31
0219,pop_asian,94,65,-29,77,88
0219,pop_black,114,70,-44,88,105
0219,pop_hisp,1592,1422,-170,1490,1558
0219,pop_nhpi,0,0,0,0,0
0219,pop_other,1,4,3,3,2
0219,pop_two,33,46,13,41,36
0219,pop_white,439,258,-181,330,403
0219,vap,1464,1294,-170,1362,1430
0219,vap_aian,23,23,0,23,23
0219,vap_asian,61,52,-9,56,59
0219,vap_black,75,63,-12,68,73
0219,vap_hisp,929,908,-21,916,925
0219,vap_nhpi,0,0,0,0,0
0219,vap_other,0,3,3,2,1
0219,vap_two,10,13,3,12,11
0219,vap_white,366,232,-134,286,339
0220,pop,2047,1948,-99,1988,2027
0220,pop_aian,17,19,2,18,17
0220,pop_asian,124,67,-57,90,113
0220,pop_black,51,37,-14,43,48
0220,pop_hisp,1442,1516,74,1486,1457
0220,pop_nhpi,0,0,0,0,0
0220,pop_other,0,2,2,1,0
0220,pop_two,28,43,15,37,31
0220,pop_white,385,264,-121,312,361
0220,vap,1367,1372,5,1370,1368
0220,vap_aian,12,12,0,12,12
0220,vap_asian,85,63,-22,72,81
0220,vap_black,33,28,-5,30,32
0220,vap_hisp,896,1020,124,970,921
0220,vap_nhpi,0,0,0,0,0
0220,vap_other,0,1,1,1,0
0220,vap_two,9,32,23,23,14
0220,vap_white,332,216,-116,262,309
0221,pop,3772,3615,-157,3678,3741
0221,pop_aian,36,26,-10,30,34
0221,pop_asian,144,106,-38,121,136
0221,pop_black,213,201,-12,206,211
0221,pop_hisp,2378,2493,115,2447,2401
0221,pop_nhpi,0,1,1,1,0
0221,pop_other,2,5,3,4,3
0221,pop_two,52,70,18,63,56
0221,pop_white,947,713,-234,807,900
0221,vap,2532,2562,30,2550,2538
0221,vap_aian,27,19,-8,22,25
0221,vap_asian,107,81,-26,91,102
0221,vap_black,139,141,2,140,139
0221,vap_hisp,1399,1622,223,1533,1444
0221,vap_nhpi,0,1,1,1,0
0221,vap_other,2,4,2,3,2
0221,vap_two,20,39,19,31,24
0221,vap_white,838,655,-183,728,801
0222,pop,2962,2860,-102,2901,2942
0222,pop_aian,52,22,-30,34,46
0222,pop_asian,101,155,54,133,112
0222,pop_black,207,247,40,231,215
0222,pop_hisp,2093,2065,-28,2076,2087
0222,pop_nhpi,1,2,1,2,1
0222,pop_other,1,20,19,12,5
0222,pop_two,51,51,0,51,51
0222,pop_white,457,298,-159,362,425
0222,vap,1919,1905,-14,1911,1916
0222,vap_aian,34,20,-14,26,31
0222,vap_asian,66,101,35,87,73
0222,vap_black,117,168,51,148,127
0222,vap_hisp,1283,1315,32,1302,1289
0222,vap_nhpi,1,2,1,2,1
0222,vap_other,0,11,11,7,2
0222,vap_two,20,27,7,24,21
0222,vap_white,398,261,-137,316,371
0223,pop,3194,2931,-263,3036,3141
0223,pop_aian,49,18,-31,30,43
0223,pop_asian,48,99,51,79,58
0223,pop_black,120,100,-20,108,116
0223,pop_hisp,2388,2257,-131,2309,2362
0223,pop_nhpi,0,2,2,1,0
0223,pop_other,3,3,0,3,3
0223,pop_two,52,54,2,53,52
0223,pop_white,534,398,-136,452,507
0223,vap,2068,1914,-154,1976,2037
0223,vap_aian,36,10,-26,20,31
0223,vap_asian,34,69,35,55,41
0223,vap_black,64,65,1,65,64
0223,vap_hisp,1431,1418,-13,1423,1428
0223,vap_nhpi,0,2,2,1,0
0223,vap_other,3,3,0,3,3
0223,vap_two,26,20,-6,22,25
0223,vap_white,474,327,-147,386,445
0224,pop,2914,2713,-201,2793,2874
0224,pop_aian,27,41,14,35,30
0224,pop_asian,52,62,10,58,54
0224,pop_black,157,186,29,174,163
0224,pop_hisp,2113,2012,-101,2052,2093
0224,pop_nhpi,0,0,0,0,0
0224,pop_other,3,4,1,4,3
0224,pop_two,54,63,9,59,56
0224,pop_white,508,345,-163,410,475
0224,vap,1860,1833,-27,1844,1855
0224,vap_aian,19,25,6,23,20
0224,vap_asian,33,44,11,40,35
0224,vap_black,96,121,25,111,101
0224,vap_hisp,1236,1311,75,1281,1251
0224,vap_nhpi,0,0,0,0,0
0224,vap_other,3,2,-1,2,3
0224,vap_two,29,29,0,29,29
0224,vap_white,444,301,-143,358,415
0225,pop,2977,2751,-226,2841,2932
0225,pop_aian,26,12,-14,18,23
0225,pop_asian,53,152,99,112,73
0225,pop_black,396,243,-153,304,365
0225,pop_hisp,2081,2010,-71,2038,2067
0225,pop_nhpi,1,0,-1,0,1
0225,pop_other,1,7,6,5,2
0225,pop_two,50,76,26,66,55
0225,pop_white,369,251,-118,298,345
0225,vap,1812,1732,-80,1764,1796
0225,vap_aian,16,7,-9,11,14
0225,vap_asian,28,88,60,64,40
0225,vap_black,198,133,-65,159,185
0225,vap_hisp,1237,1268,31,1256,1243
0225,vap_nhpi,1,0,-1,0,1
0225,vap_other,0,2,2,1,0
0225,vap_two,19,27,8,24,21
0225,vap_white,313,207,-106,249,292
0226,pop,1493,1360,-133,1413,1466
0226,pop_aian,20,16,-4,18,19
0226,pop_asian,31,49,18,42,35
0226,pop_black,165,132,-33,145,158
0226,pop_hisp,998,986,-12,991,996
0226,pop_nhpi,1,0,-1,0,1
0226,pop_other,8,2,-6,4,7
0226,pop_two,39,26,-13,31,36
0226,pop_white,231,149,-82,182,215
0226,vap,969,887,-82,920,953
0226,vap_aian,13,10,-3,11,12
0226,vap_asian,21,37,16,31,24
0226,vap_black,111,92,-19,100,107
0226,vap_hisp,610,608,-2,609,610
0226,vap_nhpi,1,0,-1,0,1
0226,vap_other,4,1,-3,2,3
0226,vap_two,16,17,1,17,16
0226,vap_white,193,122,-71,150,179
0227,pop,2671,2508,-163,2573,2638
0227,pop_aian,29,15,-14,21,26
0227,pop_asian,131,56,-75,86,116
0227,pop_black,479,574,95,536,498
0227,pop_hisp,1336,1408,72,1379,1350
0227,pop_nhpi,0,6,6,4,1
0227,pop_other,0,14,14,8,3
0227,pop_two,57,79,22,70,61
0227,pop_white,639,356,-283,469,582
0227,vap,2025,1943,-82,1976,2009
0227,vap_aian,26,13,-13,18,23
0227,vap_asian,104,49,-55,71,93
0227,vap_black,382,480,98,441,402
0227,vap_hisp,880,989,109,945,902
0227,vap_nhpi,0,5,5,3,1
0227,vap_other,0,9,9,5,2
0227,vap_two,32,58,26,48,37
0227,vap_white,601,340,-261,444,549
0228,pop,2113,1959,-154,2021,2082
0228,pop_aian,10,4,-6,6,9
0228,pop_asian,53,72,19,64,57
0228,pop_black,271,133,-138,188,243
0228,pop_hisp,1502,1508,6,1506,1503
0228,pop_nhpi,1,1,0,1,1
0228,pop_other,0,4,4,2,1
0228,pop_two,26,35,9,31,28
0228,pop_white,250,202,-48,221,240
0228,vap,1422,1257,-165,1323,1389
0228,vap_aian,7,4,-3,5,6
0228,vap_asian,37,59,22,50,41
0228,vap_black,160,98,-62,123,148
0228,vap_hisp,995,919,-76,949,980
0228,vap_nhpi,1,1,0,1,1
0228,vap_other,0,2,2,1,0
0228,vap_two,13,21,8,18,15
0228,vap_white,209,153,-56,175,198
0229,pop,2160,2058,-102,2099,2140
0229,pop_aian,5,14,9,10,7
0229,pop_asian,39,94,55,72,50
0229,pop_black,186,153,-33,166,179
0229,pop_hisp,1622,1559,-63,1584,1609
0229,pop_nhpi,0,1,1,1,0
0229,pop_other,3,13,10,9,5
0229,pop_two,37,49,12,44,39
0229,pop_white,269,175,-94,213,250
0229,vap,1369,1360,-9,1364,1367
0229,vap_aian,3,9,6,7,4
0229,vap_asian,26,57,31,45,32
0229,vap_black,112,93,-19,101,108
0229,vap_hisp,995,1021,26,1011,1000
0229,vap_nhpi,0,1,1,1,0
0229,vap_other,0,9,9,5,2
0229,vap_two,14,34,20,26,18
0229,vap_white,219,136,-83,169,202
0230,pop,3201,2932,-269,3040,3147
0230,pop_aian,27,7,-20,15,23
0230,pop_asian,66,108,42,91,74
0230,pop_black,308,280,-28,291,302
0230,pop_hisp,2344,2162,-182,2235,2308
0230,pop_nhpi,0,0,0,0,0
0230,pop_other,2,10,8,7,4
0230,pop_two,44,73,29,61,50
0230,pop_white,410,292,-118,339,386
0230,vap,2052,1972,-80,2004,2036
0230,vap_aian,23,7,-16,13,20
0230,vap_asian,40,54,14,48,43
0230,vap_black,183,191,8,188,185
0230,vap_hisp,1443,1430,-13,1435,1440
0230,vap_nhpi,0,0,0,0,0
0230,vap_other,2,6,4,4,3
0230,vap_two,14,37,23,28,19
0230,vap_white,347,247,-100,287,327
0231,pop,1947,1739,-208,1822,1905
0231,pop_aian,6,11,5,9,7
0231,pop_asian,54,73,19,65,58
0231,pop_black,190,130,-60,154,178
0231,pop_hisp,1506,1383,-123,1432,1481
0231,pop_nhpi,1,0,-1,0,1
0231,pop_other,5,6,1,6,5
0231,pop_two,21,31,10,27,23
0231,pop_white,164,105,-59,129,152
0231,vap,1210,1073,-137,1128,1183
0231,vap_aian,6,5,-1,5,6
0231,vap_asian,37,44,7,41,38
0231,vap_black,108,87,-21,95,104
0231,vap_hisp,907,821,-86,855,890
0231,vap_nhpi,1,0,-1,0,1
0231,vap_other,4,0,-4,2,3
0231,vap_two,9,20,11,16,11
0231,vap_white,138,96,-42,113,130
0232,pop,1860,1601,-259,1705,1808
0232,pop_aian,22,13,-9,17,20
0232,pop_asian,18,76,58,53,30
0232,pop_black,212,139,-73,168,197
0232,pop_hisp,1457,1225,-232,1318,1411
0232,pop_nhpi,1,2,1,2,1
0232,pop_other,0,8,8,5,2
0232,pop_two,11,11,0,11,11
0232,pop_white,139,127,-12,132,137
0232,vap,1190,1063,-127,1114,1165
0232,vap_aian,14,10,-4,12,13
0232,vap_asian,13,41,28,30,19
0232,vap_black,118,86,-32,99,112
0232,vap_hisp,927,809,-118,856,903
0232,vap_nhpi,1,2,1,2,1
0232,vap_other,0,7,7,4,1
0232,vap_two,5,5,0,5,5
0232,vap_white,112,103,-9,107,110
0233,pop,1365,1211,-154,1273,1334
0233,pop_aian,7,8,1,8,7
0233,pop_asian,11,18,7,15,12
0233,pop_black,153,66,-87,101,136
0233,pop_hisp,1058,994,-64,1020,1045
0233,pop_nhpi,0,0,0,0,0
0233,pop_other,9,0,-9,4,7
0233,pop_two,13,19,6,17,14
0233,pop_white,114,106,-8,109,112
0233,vap,900,804,-96,842,881
0233,vap_aian,7,8,1,8,7
0233,vap_asian,11,5,-6,7,10
0233,vap_black,77,47,-30,59,71
0233,vap_hisp,700,644,-56,666,689
0233,vap_nhpi,0,0,0,0,0
0233,vap_other,3,0,-3,1,2
0233,vap_two,5,11,6,9,6
0233,vap_white,97,89,-8,92,95
0234,pop,1290,1759,469,1571,1384
0234,pop_aian,5,6,1,6,5
0234,pop_asian,4,16,12,11,6
0234,pop_black,134,279,145,221,163
0234,pop_hisp,947,927,-20,935,943
0234,pop_nhpi,0,1,1,1,0
0234,pop_other,4,7,3,6,5
0234,pop_two,22,46,24,36,27
0234,pop_white,174,477,303,356,235
0234,vap,852,1301,449,1121,942
0234,vap_aian,4,4,0,4,4
0234,vap_asian,4,14,10,10,6
0234,vap_black,80,162,82,129,96
0234,vap_hisp,604,631,27,620,609
0234,vap_nhpi,0,0,0,0,0
0234,vap_other,4,1,-3,2,3
0234,vap_two,9,37,28,26,15
0234,vap_white,147,452,305,330,208
0235,pop,1941,2939,998,2540,2141
0235,pop_aian,22,12,-10,16,20
0235,pop_asian,26,100,74,70,41
0235,pop_black,153,228,75,198,168
0235,pop_hisp,584,633,49,613,594
0235,pop_nhpi,1,0,-1,0,1
0235,pop_other,3,11,8,8,5
0235,pop_two,31,115,84,81,48
0235,pop_white,1121,1840,719,1552,1265
0235,vap,1680,2631,951,2251,1870
0235,vap_aian,17,12,-5,14,16
0235,vap_asian,26,95,69,67,40
0235,vap_black,124,165,41,149,132
0235,vap_hisp,417,478,61,454,429
0235,vap_nhpi,1,0,-1,0,1
0235,vap_other,3,10,7,7,4
0235,vap_two,22,108,86,74,39
0235,vap_white,1070,1763,693,1486,1209
0236,pop,2263,1908,-355,2050,2192
0236,pop_aian,17,20,3,19,18
0236,pop_asian,68,34,-34,48,61
0236,pop_black,195,216,21,208,199
0236,pop_hisp,1715,1434,-281,1546,1659
0236,pop_nhpi,0,0,0,0,0
0236,pop_other,0,9,9,5,2
0236,pop_two,27,33,6,31,28
0236,pop_white,241,162,-79,194,225
0236,vap,1528,1375,-153,1436,1497
0236,vap_aian,13,19,6,17,14
0236,vap_asian,40,21,-19,29,36
0236,vap_black,120,172,52,151,130
0236,vap_hisp,1131,988,-143,1045,1102
0236,vap_nhpi,0,0,0,0,0
0236,vap_other,0,2,2,1,0
0236,vap_two,9,23,14,17,12
0236,vap_white,215,150,-65,176,202
0237,pop,3033,2611,-422,2780,2949
0237,pop_aian,21,36,15,30,24
0237,pop_asian,32,53,21,45,36
0237,pop_black,303,317,14,311,306
0237,pop_hisp,2332,1926,-406,2088,2251
0237,pop_nhpi,5,0,-5,2,4
0237,pop_other,4,5,1,5,4
0237,pop_two,35,29,-6,31,34
0237,pop_white,301,245,-56,267,290
0237,vap,1992,1826,-166,1892,1959
0237,vap_aian,15,32,17,25,18
0237,vap_asian,22,33,11,29,24
0237,vap_black,197,235,38,220,205
0237,vap_hisp,1465,1286,-179,1358,1429
0237,vap_nhpi,4,0,-4,2,3
0237,vap_other,2,1,-1,1,2
0237,vap_two,19,24,5,22,20
0237,vap_white,268,215,-53,236,257
0238,pop,2831,2547,-284,2661,2774
0238,pop_aian,23,10,-13,15,20
0238,pop_asian,41,109,68,82,55
0238,pop_black,264,204,-60,228,252
0238,pop_hisp,2093,2004,-89,2040,2075
0238,pop_nhpi,0,0,0,0,0
0238,pop_other,0,12,12,7,2
0238,pop_two,44,34,-10,38,42
0238,pop_white,366,174,-192,251,328
0238,vap,1742,1677,-65,1703,1729
0238,vap_aian,16,9,-7,12,15
0238,vap_asian,21,72,51,52,31
0238,vap_black,146,119,-27,130,141
0238,vap_hisp,1259,1302,43,1285,1268
0238,vap_nhpi,0,0,0,0,0
0238,vap_other,0,4,4,2,1
0238,vap_two,14,13,-1,13,14
0238,vap_white,286,158,-128,209,260
0239,pop,2296,1994,-302,2115,2236
0239,pop_aian,31,14,-17,21,28
0239,pop_asian,18,48,30,36,24
0239,pop_black,224,139,-85,173,207
0239,pop_hisp,1675,1449,-226,1539,1630
0239,pop_nhpi,0,0,0,0,0
0239,pop_other,8,8,0,8,8
0239,pop_two,30,62,32,49,36
0239,pop_white,310,274,-36,288,303
0239,vap,1506,1363,-143,1420,1477
0239,vap_aian,27,14,-13,19,24
0239,vap_asian,17,26,9,22,19
0239,vap_black,126,100,-26,110,121
0239,vap_hisp,1038,937,-101,977,1018
0239,vap_nhpi,0,0,0,0,0
0239,vap_other,8,8,0,8,8
0239,vap_two,14,36,22,27,18
0239,vap_white,276,242,-34,256,269
0240,pop,2262,2074,-188,2149,2224
0240,pop_aian,27,10,-17,17,24
0240,pop_asian,15,48,33,35,22
0240,pop_black,342,357,15,351,345
0240,pop_hisp,1479,1245,-234,1339,1432
0240,pop_nhpi,0,0,0,0,0
0240,pop_other,3,14,11,10,5
0240,pop_two,51,50,-1,50,51
0240,pop_white,345,350,5,348,346
0240,vap,1520,1445,-75,1475,1505
0240,vap_aian,21,9,-12,14,19
0240,vap_asian,11,29,18,22,15
0240,vap_black,193,210,17,203,196
0240,vap_hisp,959,844,-115,890,936
0240,vap_nhpi,0,0,0,0,0
0240,vap_other,1,12,11,8,3
0240,vap_two,26,24,-2,25,26
0240,vap_white,309,317,8,314,311
0241,pop,1704,1991,287,1876,1761
0241,pop_aian,19,11,-8,14,17
0241,pop_asian,22,61,39,45,30
0241,pop_black,61,55,-6,57,60
0241,pop_hisp,297,301,4,299,298
0241,pop_nhpi,0,0,0,0,0
0241,pop_other,1,10,9,6,3
0241,pop_two,33,60,27,49,38
0241,pop_white,1271,1493,222,1404,1315
0241,vap,1459,1794,335,1660,1526
0241,vap_aian,14,8,-6,10,13
0241,vap_asian,17,45,28,34,23
0241,vap_black,48,41,-7,44,47
0241,vap_hisp,209,246,37,231,216
0241,vap_nhpi,0,0,0,0,0
0241,vap_other,0,10,10,6,2
0241,vap_two,19,51,32,38,25
0241,vap_white,1152,1393,241,1297,1200
0242,pop,1318,1361,43,1344,1327
0242,pop_aian,21,8,-13,13,18
0242,pop_asian,7,27,20,19,11
0242,pop_black,41,34,-7,37,40
0242,pop_hisp,111,217,106,175,132
0242,pop_nhpi,1,1,0,1,1
0242,pop_other,2,3,1,3,2
0242,pop_two,45,77,32,64,51
0242,pop_white,1090,994,-96,1032,1071
0242,vap,1133,1176,43,1159,1142
0242,vap_aian,13,8,-5,10,12
0242,vap_asian,7,26,19,18,11
0242,vap_black,28,29,1,29,28
0242,vap_hisp,75,139,64,113,88
0242,vap_nhpi,1,1,0,1,1
0242,vap_other,1,3,2,2,1
0242,vap_two,20,50,30,38,26
0242,vap_white,988,920,-68,947,974
0243,pop,1395,1406,11,1402,1397
0243,pop_aian,7,3,-4,5,6
0243,pop_asian,19,22,3,21,20
0243,pop_black,15,10,-5,12,14
0243,pop_hisp,85,117,32,104,91
0243,pop_nhpi,1,0,-1,0,1
0243,pop_other,4,9,5,7,5
0243,pop_two,21,54,33,41,28
0243,pop_white,1243,1191,-52,1212,1233
0243,vap,1222,1216,-6,1218,1221
0243,vap_aian,6,0,-6,2,5
0243,vap_asian,15,17,2,16,15
0243,vap_black,11,8,-3,9,10
0243,vap_hisp,58,77,19,69,62
0243,vap_nhpi,1,0,-1,0,1
0243,vap_other,2,4,2,3,2
0243,vap_two,11,38,27,27,16
0243,vap_white,1118,1072,-46,1090,1109
0244,pop,1298,1207,-91,1243,1280
0244,pop_aian,6,4,-2,5,6
0244,pop_asian,11,17,6,15,12
0244,pop_black,19,38,19,30,23
0244,pop_hisp,136,107,-29,119,130
0244,pop_nhpi,1,0,-1,0,1
0244,pop_other,0,2,2,1,0
0244,pop_two,43,56,13,51,46
0244,pop_white,1082,983,-99,1023,1062
0244,vap,1047,1020,-27,1031,1042
0244,vap_aian,5,4,-1,4,5
0244,vap_asian,9,17,8,14,11
0244,vap_black,9,23,14,17,12
0244,vap_hisp,83,87,4,85,84
0244,vap_nhpi,1,0,-1,0,1
0244,vap_other,0,1,1,1,0
0244,vap_two,13,30,17,23,16
0244,vap_white,927,858,-69,886,913
0245,pop,1007,974,-33,987,1000
0245,pop_aian,0,1,1,1,0
0245,pop_asian,10,10,0,10,10
0245,pop_black,16,19,3,18,17
0245,pop_hisp,64,82,18,75,68
0245,pop_nhpi,0,0,0,0,0
0245,pop_other,0,5,5,3,1
0245,pop_two,19,33,14,27,22
0245,pop_white,898,824,-74,854,883
0245,vap,850,832,-18,839,846
0245,vap_aian,0,1,1,1,0
0245,vap_asian,10,9,-1,9,10
0245,vap_black,7,19,12,14,9
0245,vap_hisp,42,56,14,50,45
0245,vap_nhpi,0,0,0,0,0
0245,vap_other,0,3,3,2,1
0245,vap_two,11,19,8,16,13
0245,vap_white,780,725,-55,747,769
0246,pop,1893,1781,-112,1826,1871
0246,pop_aian,18,18,0,18,18
0246,pop_asian,13,19,6,17,14
0246,pop_black,49,19,-30,31,43
0246,pop_hisp,173,173,0,173,173
0246,pop_nhpi,3,1,-2,2,3
0246,pop_other,0,9,9,5,2
0246,pop_two,44,106,62,81,56
0246,pop_white,1593,1436,-157,1499,1562
0246,vap,1571,1515,-56,1537,1560
0246,vap_aian,14,15,1,15,14
0246,vap_asian,11,14,3,13,12
0246,vap_black,23,12,-11,16,21
0246,vap_hisp,114,133,19,125,118
0246,vap_nhpi,3,1,-2,2,3
0246,vap_other,0,7,7,4,1
0246,vap_two,29,64,35,50,36
0246,vap_white,1377,1269,-108,1312,1355
0247,pop,1060,955,-105,997,1039
0247,pop_aian,7,1,-6,3,6
0247,pop_asian,7,10,3,9,8
0247,pop_black,24,27,3,26,25
0247,pop_hisp,182,142,-40,158,174
0247,pop_nhpi,0,0,0,0,0
0247,pop_other,0,8,8,5,2
0247,pop_two,34,42,8,39,36
0247,pop_white,806,725,-81,757,790
0247,vap,832,787,-45,805,823
0247,vap_aian,7,0,-7,3,6
0247,vap_asian,6,7,1,7,6
0247,vap_black,14,22,8,19,16
0247,vap_hisp,107,102,-5,104,106
0247,vap_nhpi,0,0,0,0,0
0247,vap_other,0,2,2,1,0
0247,vap_two,14,25,11,21,16
0247,vap_white,684,629,-55,651,673
0248,pop,2161,1974,-187,2049,2124
0248,pop_aian,29,18,-11,22,27
0248,pop_asian,43,47,4,45,44
0248,pop_black,115,76,-39,92,107
0248,pop_hisp,407,320,-87,355,390
0248,pop_nhpi,2,0,-2,1,2
0248,pop_other,1,8,7,5,2
0248,pop_two,81,70,-11,74,79
0248,pop_white,1483,1435,-48,1454,1473
0248,vap,1774,1700,-74,1730,1759
0248,vap_aian,19,14,-5,16,18
0248,vap_asian,39,43,4,41,40
0248,vap_black,92,60,-32,73,86
0248,vap_hisp,264,233,-31,245,258
0248,vap_nhpi,2,0,-2,1,2
0248,vap_other,1,8,7,5,2
0248,vap_two,42,54,12,49,44
0248,vap_white,1315,1288,-27,1299,1310
0249,pop,2062,1858,-204,1940,2021
0249,pop_aian,33,13,-20,21,29
0249,pop_asian,17,9,-8,12,15
0249,pop_black,206,192,-14,198,203
0249,pop_hisp,1222,1201,-21,1209,1218
0249,pop_nhpi,14,2,-12,7,12
0249,pop_other,8,11,3,10,9
0249,pop_two,57,60,3,59,58
0249,pop_white,505,370,-135,424,478
0249,vap,1299,1203,-96,1241,1280
0249,vap_aian,19,8,-11,12,17
0249,vap_asian,14,6,-8,9,12
0249,vap_black,118,125,7,122,119
0249,vap_hisp,696,735,39,719,704
0249,vap_nhpi,6,1,-5,3,5
0249,vap_other,0,6,6,4,1
0249,vap_two,20,31,11,27,22
0249,vap_white,426,291,-135,345,399
0250,pop,1749,1500,-249,1600,1699
0250,pop_aian,15,12,-3,13,14
0250,pop_asian,45,95,50,75,55
0250,pop_black,91,89,-2,90,91
0250,pop_hisp,1270,1070,-200,1150,1230
0250,pop_nhpi,0,0,0,0,0
0250,pop_other,1,5,4,3,2
0250,pop_two,19,25,6,23,20
0250,pop_white,308,204,-104,246,287
0250,vap,1105,1007,-98,1046,1085
0250,vap_aian,8,10,2,9,8
0250,vap_asian,28,50,22,41,32
0250,vap_black,53,52,-1,52,53
0250,vap_hisp,745,696,-49,716,735
0250,vap_nhpi,0,0,0,0,0
0250,vap_other,0,2,2,1,0
0250,vap_two,7,18,11,14,9
0250,vap_white,264,179,-85,213,247
0251,pop,1476,1368,-108,1411,1454
0251,pop_aian,23,14,-9,18,21
0251,pop_asian,43,42,-1,42,43
0251,pop_black,74,80,6,78,75
0251,pop_hisp,1107,1061,-46,1079,1098
0251,pop_nhpi,0,0,0,0,0
0251,pop_other,0,5,5,3,1
0251,pop_two,26,28,2,27,26
0251,pop_white,203,138,-65,164,190
0251,vap,893,882,-11,886,891
0251,vap_aian,13,14,1,14,13
0251,vap_asian,29,23,-6,25,28
0251,vap_black,49,50,1,50,49
0251,vap_hisp,623,655,32,642,629
0251,vap_nhpi,0,0,0,0,0
0251,vap_other,0,5,5,3,1
0251,vap_two,11,15,4,13,12
0251,vap_white,168,120,-48,139,158
0252,pop,2551,2132,-419,2300,2467
0252,pop_aian,34,11,-23,20,29
0252,pop_asian,9,144,135,90,36
0252,pop_black,172,123,-49,143,162
0252,pop_hisp,1749,1485,-264,1591,1696
0252,pop_nhpi,0,5,5,3,1
0252,pop_other,3,2,-1,2,3
0252,pop_two,45,65,20,57,49
0252,pop_white,539,297,-242,394,491
0252,vap,1665,1438,-227,1529,1620
0252,vap_aian,30,8,-22,17,26
0252,vap_asian,8,88,80,56,24
0252,vap_black,96,86,-10,90,94
0252,vap_hisp,1044,941,-103,982,1023
0252,vap_nhpi,0,5,5,3,1
0252,vap_other,0,1,1,1,0
0252,vap_two,19,39,20,31,23
0252,vap_white,468,270,-198,349,428
0253,pop,1108,890,-218,977,1064
0253,pop_aian,12,6,-6,8,11
0253,pop_asian,13,42,29,30,19
0253,pop_black,24,9,-15,15,21
0253,pop_hisp,822,692,-130,744,796
0253,pop_nhpi,0,0,0,0,0
0253,pop_other,0,8,8,5,2
0253,pop_two,13,17,4,15,14
0253,pop_white,224,116,-108,159,202
0253,vap,730,604,-126,654,705
0253,vap_aian,9,3,-6,5,8
0253,vap_asian,9,21,12,16,11
0253,vap_black,16,9,-7,12,15
0253,vap_hisp,486,456,-30,468,480
0253,vap_nhpi,0,0,0,0,0
0253,vap_other,0,5,5,3,1
0253,vap_two,9,8,-1,8,9
0253,vap_white,201,102,-99,142,181
0254,pop,1325,1178,-147,1237,1296
0254,pop_aian,20,2,-18,9,16
0254,pop_asian,30,62,32,49,36
0254,pop_black,98,100,2,99,98
0254,pop_hisp,970,864,-106,906,949
0254,pop_nhpi,0,0,0,0,0
0254,pop_other,4,3,-1,3,4
0254,pop_two,32,33,1,33,32
0254,pop_white,171,114,-57,137,160
0254,vap,807,776,-31,788,801
0254,vap_aian,14,2,-12,7,12
0254,vap_asian,11,40,29,28,17
0254,vap_black,65,53,-12,58,63
0254,vap_hisp,560,575,15,569,563
0254,vap_nhpi,0,0,0,0,0
0254,vap_other,4,1,-3,2,3
0254,vap_two,15,19,4,17,16
0254,vap_white,138,86,-52,107,128
0255,pop,1407,1442,35,1428,1414
0255,pop_aian,25,8,-17,15,22
0255,pop_asian,24,66,42,49,32
0255,pop_black,94,166,72,137,108
0255,pop_hisp,1033,997,-36,1011,1026
0255,pop_nhpi,0,1,1,1,0
0255,pop_other,2,3,1,3,2
0255,pop_two,26,37,11,33,28
0255,pop_white,203,164,-39,180,195
0255,vap,911,928,17,921,914
0255,vap_aian,19,7,-12,12,17
0255,vap_asian,18,34,16,28,21
0255,vap_black,60,113,53,92,71
0255,vap_hisp,634,611,-23,620,629
0255,vap_nhpi,0,1,1,1,0
0255,vap_other,1,1,0,1,1
0255,vap_two,5,19,14,13,8
0255,vap_white,174,142,-32,155,168
0256,pop,1946,1894,-52,1915,1936
0256,pop_aian,22,14,-8,17,20
0256,pop_asian,19,52,33,39,26
0256,pop_black,126,98,-28,109,120
0256,pop_hisp,1465,1517,52,1496,1475
0256,pop_nhpi,0,1,1,1,0
0256,pop_other,2,1,-1,1,2
0256,pop_two,35,35,0,35,35
0256,pop_white,277,176,-101,216,257
0256,vap,1222,1285,63,1260,1235
0256,vap_aian,12,4,-8,7,10
0256,vap_asian,9,36,27,25,14
0256,vap_black,71,64,-7,67,70
0256,vap_hisp,869,1001,132,948,895
0256,vap_nhpi,0,1,1,1,0
0256,vap_other,2,1,-1,1,2
0256,vap_two,16,22,6,20,17
0256,vap_white,243,156,-87,191,226
0257,pop,3327,3178,-149,3238,3297
0257,pop_aian,32,17,-15,23,29
0257,pop_asian,61,104,43,87,70
0257,pop_black,238,222,-16,228,235
0257,pop_hisp,2428,2405,-23,2414,2423
0257,pop_nhpi,0,2,2,1,0
0257,pop_other,0,14,14,8,3
0257,pop_two,58,52,-6,54,57
0257,pop_white,510,362,-148,421,480
0257,vap,2076,2089,13,2084,2079
0257,vap_aian,26,11,-15,17,23
0257,vap_asian,43,61,18,54,47
0257,vap_black,128,139,11,135,130
0257,vap_hisp,1427,1518,91,1482,1445
0257,vap_nhpi,0,2,2,1,0
0257,vap_other,0,9,9,5,2
0257,vap_two,22,32,10,28,24
0257,vap_white,430,317,-113,362,407
0258,pop,3119,3083,-36,3097,3112
0258,pop_aian,39,17,-22,26,35
0258,pop_asian,57,31,-26,41,52
0258,pop_black,100,74,-26,84,95
0258,pop_hisp,2135,2440,305,2318,2196
0258,pop_nhpi,0,1,1,1,0
0258,pop_other,1,5,4,3,2
0258,pop_two,41,68,27,57,46
0258,pop_white,746,447,-299,567,686
0258,vap,2005,2024,19,2016,2009
0258,vap_aian,27,12,-15,18,24
0258,vap_asian,45,20,-25,30,40
0258,vap_black,65,60,-5,62,64
0258,vap_hisp,1223,1501,278,1390,1279
0258,vap_nhpi,0,0,0,0,0
0258,vap_other,1,4,3,3,2
0258,vap_two,17,40,23,31,22
0258,vap_white,627,387,-240,483,579
0259,pop,1912,1863,-49,1883,1902
0259,pop_aian,22,7,-15,13,19
0259,pop_asian,10,16,6,14,11
0259,pop_black,68,60,-8,63,66
0259,pop_hisp,1271,1435,164,1369,1304
0259,pop_nhpi,0,0,0,0,0
0259,pop_other,1,4,3,3,2
0259,pop_two,31,25,-6,27,30
0259,pop_white,509,316,-193,393,470
0259,vap,1273,1304,31,1292,1279
0259,vap_aian,17,3,-14,9,14
0259,vap_asian,8,10,2,9,8
0259,vap_black,38,40,2,39,38
0259,vap_hisp,748,926,178,855,784
0259,vap_nhpi,0,0,0,0,0
0259,vap_other,1,4,3,3,2
0259,vap_two,15,16,1,16,15
0259,vap_white,446,305,-141,361,418
0260,pop,992,1167,175,1097,1027
0260,pop_aian,8,3,-5,5,7
0260,pop_asian,44,98,54,76,55
0260,pop_black,55,109,54,87,66
0260,pop_hisp,394,576,182,503,430
0260,pop_nhpi,0,0,0,0,0
0260,pop_other,1,2,1,2,1
0260,pop_two,19,58,39,42,27
0260,pop_white,471,321,-150,381,441
0260,vap,730,844,114,798,753
0260,vap_aian,7,3,-4,5,6
0260,vap_asian,32,63,31,51,38
0260,vap_black,39,83,44,65,48
0260,vap_hisp,233,372,139,316,261
0260,vap_nhpi,0,0,0,0,0
0260,vap_other,1,2,1,2,1
0260,vap_two,11,36,25,26,16
0260,vap_white,407,285,-122,334,383
0261,pop,1010,1073,63,1048,1023
0261,pop_aian,6,11,5,9,7
0261,pop_asian,16,87,71,59,30
0261,pop_black,46,54,8,51,48
0261,pop_hisp,213,354,141,298,241
0261,pop_nhpi,0,0,0,0,0
0261,pop_other,2,9,7,6,3
0261,pop_two,18,31,13,26,21
0261,pop_white,709,527,-182,600,673
0261,vap,775,822,47,803,784
0261,vap_aian,4,5,1,5,4
0261,vap_asian,14,56,42,39,22
0261,vap_black,30,40,10,36,32
0261,vap_hisp,137,229,92,192,155
0261,vap_nhpi,0,0,0,0,0
0261,vap_other,2,8,6,6,3
0261,vap_two,10,20,10,16,12
0261,vap_white,578,464,-114,510,555
0262,pop,2004,2030,26,2020,2009
0262,pop_aian,9,15,6,13,10
0262,pop_asian,54,61,7,58,55
0262,pop_black,32,69,37,54,39
0262,pop_hisp,315,674,359,530,387
0262,pop_nhpi,0,0,0,0,0
0262,pop_other,1,9,8,6,3
0262,pop_two,25,62,37,47,32
0262,pop_white,1568,1140,-428,1311,1482
0262,vap,1523,1524,1,1524,1523
0262,vap_aian,8,11,3,10,9
0262,vap_asian,37,41,4,39,38
0262,vap_black,21,48,27,37,26
0262,vap_hisp,186,403,217,316,229
0262,vap_nhpi,0,0,0,0,0
0262,vap_other,1,9,8,6,3
0262,vap_two,11,37,26,27,16
0262,vap_white,1259,975,-284,1089,1202
0263,pop,1402,1478,76,1448,1417
0263,pop_aian,15,5,-10,9,13
0263,pop_asian,23,48,25,38,28
0263,pop_black,112,117,5,115,113
0263,pop_hisp,372,702,330,570,438
0263,pop_nhpi,0,0,0,0,0
0263,pop_other,0,0,0,0,0
0263,pop_two,32,30,-2,31,32
0263,pop_white,848,576,-272,685,794
0263,vap,1061,1111,50,1091,1071
0263,vap_aian,12,4,-8,7,10
0263,vap_asian,20,33,13,28,23
0263,vap_black,87,83,-4,85,86
0263,vap_hisp,214,463,249,363,264
0263,vap_nhpi,0,0,0,0,0
0263,vap_other,0,0,0,0,0
0263,vap_two,13,18,5,16,14
0263,vap_white,715,510,-205,592,674
0264,pop,2129,2288,159,2224,2161
0264,pop_aian,11,14,3,13,12
0264,pop_asian,40,58,18,51,44
0264,pop_black,68,102,34,88,75
0264,pop_hisp,339,654,315,528,402
0264,pop_nhpi,0,6,6,4,1
0264,pop_other,6,11,5,9,7
0264,pop_two,37,119,82,86,53
0264,pop_white,1628,1324,-304,1446,1567
0264,vap,1691,1769,78,1738,1707
0264,vap_aian,7,9,2,8,7
0264,vap_asian,29,42,13,37,32
0264,vap_black,51,80,29,68,57
0264,vap_hisp,222,417,195,339,261
0264,vap_nhpi,0,5,5,3,1
0264,vap_other,1,8,7,5,2
0264,vap_two,13,69,56,47,24
0264,vap_white,1368,1139,-229,1231,1322
0265,pop,1222,1304,82,1271,1238
0265,pop_aian,7,13,6,11,8
0265,pop_asian,5,31,26,21,10
0265,pop_black,27,27,0,27,27
0265,pop_hisp,160,355,195,277,199
0265,pop_nhpi,0,0,0,0,0
0265,pop_other,1,7,6,5,2
0265,pop_two,19,43,24,33,24
0265,pop_white,1003,828,-175,898,968
0265,vap,958,972,14,966,961
0265,vap_aian,7,12,5,10,8
0265,vap_asian,5,18,13,13,8
0265,vap_black,11,15,4,13,12
0265,vap_hisp,83,200,117,153,106
0265,vap_nhpi,0,0,0,0,0
0265,vap_other,1,6,5,4,2
0265,vap_two,13,23,10,19,15
0265,vap_white,838,698,-140,754,810
0266,pop,1322,1460,138,1405,1350
0266,pop_aian,6,11,5,9,7
0266,pop_asian,22,53,31,41,28
0266,pop_black,15,56,41,40,23
0266,pop_hisp,157,341,184,267,194
0266,pop_nhpi,1,0,-1,0,1
0266,pop_other,0,2,2,1,0
0266,pop_two,28,61,33,48,35
0266,pop_white,1093,936,-157,999,1062
0266,vap,1058,1153,95,1115,1077
0266,vap_aian,6,8,2,7,6
0266,vap_asian,15,40,25,30,20
0266,vap_black,11,45,34,31,18
0266,vap_hisp,97,220,123,171,122
0266,vap_nhpi,1,0,-1,0,1
0266,vap_other,0,2,2,1,0
0266,vap_two,15,35,20,27,19
0266,vap_white,913,803,-110,847,891
0267,pop,1070,1209,139,1153,1098
0267,pop_aian,11,9,-2,10,11
0267,pop_asian,9,45,36,31,16
0267,pop_black,17,36,19,28,21
0267,pop_hisp,107,325,218,238,151
0267,pop_nhpi,0,0,0,0,0
0267,pop_other,1,4,3,3,2
0267,pop_two,19,39,20,31,23
0267,pop_white,906,751,-155,813,875
0267,vap,874,943,69,915,888
0267,vap_aian,7,7,0,7,7
0267,vap_asian,7,26,19,18,11
0267,vap_black,8,25,17,18,11
0267,vap_hisp,63,196,133,143,90
0267,vap_nhpi,0,0,0,0,0
0267,vap_other,0,3,3,2,1
0267,vap_two,5,25,20,17,9
0267,vap_white,784,661,-123,710,759
0268,pop,2810,2927,117,2880,2833
0268,pop_aian,32,21,-11,25,30
0268,pop_asian,45,97,52,76,55
0268,pop_black,89,112,23,103,94
0268,pop_hisp,393,843,450,663,483
0268,pop_nhpi,0,1,1,1,0
0268,pop_other,6,9,3,8,7
0268,pop_two,60,104,44,86,69
0268,pop_white,2185,1740,-445,1918,2096
0268,vap,2220,2316,96,2278,2239
0268,vap_aian,21,19,-2,20,21
0268,vap_asian,33,70,37,55,40
0268,vap_black,53,79,26,69,58
0268,vap_hisp,250,534,284,420,307
0268,vap_nhpi,0,1,1,1,0
0268,vap_other,5,6,1,6,5
0268,vap_two,21,69,48,50,31
0268,vap_white,1837,1538,-299,1658,1777
0269,pop,1738,1736,-2,1737,1738
0269,pop_aian,10,8,-2,9,10
0269,pop_asian,31,82,51,62,41
0269,pop_black,62,125,63,100,75
0269,pop_hisp,201,332,131,280,227
0269,pop_nhpi,0,1,1,1,0
0269,pop_other,2,4,2,3,2
0269,pop_two,21,61,40,45,29
0269,pop_white,1411,1123,-288,1238,1353
0269,vap,1449,1398,-51,1418,1439
0269,vap_aian,6,8,2,7,6
0269,vap_asian,24,51,27,40,29
0269,vap_black,44,86,42,69,52
0269,vap_hisp,123,223,100,183,143
0269,vap_nhpi,0,0,0,0,0
0269,vap_other,1,1,0,1,1
0269,vap_two,11,39,28,28,17
0269,vap_white,1240,990,-250,1090,1190
0270,pop,1537,1546,9,1542,1539
0270,pop_aian,12,10,-2,11,12
0270,pop_asian,26,72,46,54,35
0270,pop_black,30,40,10,36,32
0270,pop_hisp,111,317,206,235,152
0270,pop_nhpi,0,0,0,0,0
0270,pop_other,1,3,2,2,1
0270,pop_two,21,85,64,59,34
0270,pop_white,1336,1019,-317,1146,1273
0270,vap,1197,1205,8,1202,1199
0270,vap_aian,8,7,-1,7,8
0270,vap_asian,23,49,26,39,28
0270,vap_black,15,29,14,23,18
0270,vap_hisp,67,181,114,135,90
0270,vap_nhpi,0,0,0,0,0
0270,vap_other,1,2,1,2,1
0270,vap_two,11,48,37,33,18
0270,vap_white,1072,889,-183,962,1035
0271,pop,2677,2679,2,2678,2677
0271,pop_aian,11,18,7,15,12
0271,pop_asian,56,92,36,78,63
0271,pop_black,65,155,90,119,83
0271,pop_hisp,279,395,116,349,302
0271,pop_nhpi,0,0,0,0,0
0271,pop_other,2,21,19,13,6
0271,pop_two,28,116,88,81,46
0271,pop_white,2236,1882,-354,2024,2165
0271,vap,2190,2238,48,2219,2200
0271,vap_aian,7,14,7,11,8
0271,vap_asian,43,69,26,59,48
0271,vap_black,54,122,68,95,68
0271,vap_hisp,159,249,90,213,177
0271,vap_nhpi,0,0,0,0,0
0271,vap_other,1,21,20,13,5
0271,vap_two,11,78,67,51,24
0271,vap_white,1915,1685,-230,1777,1869
0272,pop,2019,1883,-136,1937,1992
0272,pop_aian,20,8,-12,13,18
0272,pop_asian,18,42,24,32,23
0272,pop_black,69,98,29,86,75
0272,pop_hisp,240,289,49,269,250
0272,pop_nhpi,4,0,-4,2,3
0272,pop_other,5,2,-3,3,4
0272,pop_two,43,95,52,74,53
0272,pop_white,1620,1349,-271,1457,1566
0272,vap,1455,1501,46,1483,1464
0272,vap_aian,13,7,-6,9,12
0272,vap_asian,9,36,27,25,14
0272,vap_black,42,70,28,59,48
0272,vap_hisp,133,183,50,163,143
0272,vap_nhpi,2,0,-2,1,2
0272,vap_other,1,2,1,2,1
0272,vap_two,11,39,28,28,17
0272,vap_white,1244,1164,-80,1196,1228
0273,pop,1199,1180,-19,1188,1195
0273,pop_aian,9,5,-4,7,8
0273,pop_asian,25,22,-3,23,24
0273,pop_black,15,52,37,37,22
0273,pop_hisp,100,237,137,182,127
0273,pop_nhpi,0,0,0,0,0
0273,pop_other,0,10,10,6,2
0273,pop_two,27,52,25,42,32
0273,pop_white,1023,802,-221,890,979
0273,vap,912,852,-60,876,900
0273,vap_aian,9,2,-7,5,8
0273,vap_asian,22,19,-3,20,21
0273,vap_black,7,29,22,20,11
0273,vap_hisp,49,120,71,92,63
0273,vap_nhpi,0,0,0,0,0
0273,vap_other,0,8,8,5,2
0273,vap_two,11,28,17,21,14
0273,vap_white,814,646,-168,713,780
0274,pop,1204,1238,34,1224,1211
0274,pop_aian,11,13,2,12,11
0274,pop_asian,15,34,19,26,19
0274,pop_black,32,58,26,48,37
0274,pop_hisp,146,273,127,222,171
0274,pop_nhpi,0,0,0,0,0
0274,pop_other,4,5,1,5,4
0274,pop_two,31,48,17,41,34
0274,pop_white,965,807,-158,870,933
0274,vap,901,948,47,929,910
0274,vap_aian,8,11,3,10,9
0274,vap_asian,11,29,18,22,15
0274,vap_black,23,42,19,34,27
0274,vap_hisp,87,173,86,139,104
0274,vap_nhpi,0,0,0,0,0
0274,vap_other,2,3,1,3,2
0274,vap_two,7,20,13,15,10
0274,vap_white,763,670,-93,707,744
0275,pop,2969,3022,53,3001,2980
0275,pop_aian,34,18,-16,24,31
0275,pop_asian,94,179,85,145,111
0275,pop_black,142,206,64,180,155
0275,pop_hisp,442,625,183,552,479
0275,pop_nhpi,0,0,0,0,0
0275,pop_other,5,10,5,8,6
0275,pop_two,90,209,119,161,114
0275,pop_white,2162,1775,-387,1930,2085
0275,vap,2249,2302,53,2281,2260
0275,vap_aian,24,18,-6,20,23
0275,vap_asian,76,126,50,106,86
0275,vap_black,82,143,61,119,94
0275,vap_hisp,259,385,126,335,284
0275,vap_nhpi,0,0,0,0,0
0275,vap_other,3,4,1,4,3
0275,vap_two,47,115,68,88,61
0275,vap_white,1758,1511,-247,1610,1709
0276,pop,2097,2299,202,2218,2137
0276,pop_aian,10,8,-2,9,10
0276,pop_asian,79,206,127,155,104
0276,pop_black,10,74,64,48,23
0276,pop_hisp,185,378,193,301,224
0276,pop_nhpi,2,1,-1,1,2
0276,pop_other,7,10,3,9,8
0276,pop_two,29,86,57,63,40
0276,pop_white,1775,1536,-239,1632,1727
0276,vap,1666,1815,149,1755,1696
0276,vap_aian,9,8,-1,8,9
0276,vap_asian,57,124,67,97,70
0276,vap_black,9,56,47,37,18
0276,vap_hisp,112,247,135,193,139
0276,vap_nhpi,2,1,-1,1,2
0276,vap_other,3,7,4,5,4
0276,vap_two,15,48,33,35,22
0276,vap_white,1459,1324,-135,1378,1432
0277,pop,2531,2602,71,2574,2545
0277,pop_aian,24,15,-9,19,22
0277,pop_asian,36,109,73,80,51
0277,pop_black,68,152,84,118,85
0277,pop_hisp,345,649,304,527,406
0277,pop_nhpi,0,1,1,1,0
0277,pop_other,2,8,6,6,3
0277,pop_two,63,92,29,80,69
0277,pop_white,1993,1576,-417,1743,1910
0277,vap,2030,2123,93,2086,2049
0277,vap_aian,14,13,-1,13,14
0277,vap_asian,31,76,45,58,40
0277,vap_black,50,110,60,86,62
0277,vap_hisp,224,461,237,366,271
0277,vap_nhpi,0,1,1,1,0
0277,vap_other,0,8,8,5,2
0277,vap_two,32,61,29,49,38
0277,vap_white,1679,1393,-286,1507,1622
0278,pop,1483,1548,65,1522,1496
0278,pop_aian,16,16,0,16,16
0278,pop_asian,22,66,44,48,31
0278,pop_black,68,78,10,74,70
0278,pop_hisp,251,390,139,334,279
0278,pop_nhpi,0,0,0,0,0
0278,pop_other,1,2,1,2,1
0278,pop_two,20,55,35,41,27
0278,pop_white,1105,941,-164,1007,1072
0278,vap,1159,1157,-2,1158,1159
0278,vap_aian,15,16,1,16,15
0278,vap_asian,17,45,28,34,23
0278,vap_black,39,57,18,50,43
0278,vap_hisp,153,242,89,206,171
0278,vap_nhpi,0,0,0,0,0
0278,vap_other,0,1,1,1,0
0278,vap_two,12,24,12,19,14
0278,vap_white,923,772,-151,832,893
0279,pop,2127,2213,86,2179,2144
0279,pop_aian,16,13,-3,14,15
0279,pop_asian,43,88,45,70,52
0279,pop_black,35,82,47,63,44
0279,pop_hisp,323,718,395,560,402
0279,pop_nhpi,0,0,0,0,0
0279,pop_other,0,13,13,8,3
0279,pop_two,22,96,74,66,37
0279,pop_white,1688,1203,-485,1397,1591
0279,vap,1670,1638,-32,1651,1664
0279,vap_aian,13,9,-4,11,12
0279,vap_asian,34,56,22,47,38
0279,vap_black,23,63,40,47,31
0279,vap_hisp,185,423,238,328,233
0279,vap_nhpi,0,0,0,0,0
0279,vap_other,0,6,6,4,1
0279,vap_two,12,48,36,34,19
0279,vap_white,1403,1033,-370,1181,1329
0280,pop,3586,3685,99,3645,3606
0280,pop_aian,23,18,-5,20,22
0280,pop_asian,152,233,81,201,168
0280,pop_black,245,338,93,301,264
0280,pop_hisp,780,1278,498,1079,880
0280,pop_nhpi,4,1,-3,2,3
0280,pop_other,0,12,12,7,2
0280,pop_two,91,151,60,127,103
0280,pop_white,2291,1654,-637,1909,2164
0280,vap,2829,2839,10,2835,2831
0280,vap_aian,20,18,-2,19,20
0280,vap_asian,117,144,27,133,122
0280,vap_black,171,267,96,229,190
0280,vap_hisp,513,876,363,731,586
0280,vap_nhpi,3,1,-2,2,3
0280,vap_other,0,10,10,6,2
0280,vap_two,34,90,56,68,45
0280,vap_white,1971,1433,-538,1648,1863
0281,pop,1646,1759,113,1714,1669
0281,pop_aian,14,18,4,16,15
0281,pop_asian,92,298,206,216,133
0281,pop_black,76,65,-11,69,74
0281,pop_hisp,528,719,191,643,566
0281,pop_nhpi,0,0,0,0,0
0281,pop_other,2,11,9,7,4
0281,pop_two,34,70,36,56,41
0281,pop_white,900,578,-322,707,836
0281,vap,1243,1224,-19,1232,1239
0281,vap_aian,12,18,6,16,13
0281,vap_asian,56,161,105,119,77
0281,vap_black,51,45,-6,47,50
0281,vap_hisp,332,449,117,402,355
0281,vap_nhpi,0,0,0,0,0
0281,vap_other,0,5,5,3,1
0281,vap_two,18,43,25,33,23
0281,vap_white,774,503,-271,611,720
0282,pop,1293,1363,70,1335,1307
0282,pop_aian,12,6,-6,8,11
0282,pop_asian,160,301,141,245,188
0282,pop_black,169,289,120,241,193
0282,pop_hisp,429,380,-49,400,419
0282,pop_nhpi,0,0,0,0,0
0282,pop_other,0,10,10,6,2
0282,pop_two,37,35,-2,36,37
0282,pop_white,486,342,-144,400,457
0282,vap,989,1023,34,1009,996
0282,vap_aian,11,6,-5,8,10
0282,vap_asian,103,181,78,150,119
0282,vap_black,125,222,97,183,144
0282,vap_hisp,281,281,0,281,281
0282,vap_nhpi,0,0,0,0,0
0282,vap_other,0,4,4,2,1
0282,vap_two,22,20,-2,21,22
0282,vap_white,447,309,-138,364,419
0283,pop,1959,2191,232,2098,2005
0283,pop_aian,13,6,-7,9,12
0283,pop_asian,71,350,279,238,127
0283,pop_black,119,191,72,162,133
0283,pop_hisp,835,1044,209,960,877
0283,pop_nhpi,0,0,0,0,0
0283,pop_other,8,13,5,11,9
0283,pop_two,36,46,10,42,38
0283,pop_white,878,541,-337,676,811
0283,vap,1414,1497,83,1464,1431
0283,vap_aian,10,6,-4,8,9
0283,vap_asian,60,219,159,155,92
0283,vap_black,72,120,48,101,82
0283,vap_hisp,489,669,180,597,525
0283,vap_nhpi,0,0,0,0,0
0283,vap_other,8,13,5,11,9
0283,vap_two,20,18,-2,19,20
0283,vap_white,754,452,-302,573,694
0284,pop,1732,1912,180,1840,1768
0284,pop_aian,22,9,-13,14,19
0284,pop_asian,19,125,106,83,40
0284,pop_black,200,202,2,201,200
0284,pop_hisp,899,1207,308,1084,961
0284,pop_nhpi,0,0,0,0,0
0284,pop_other,0,5,5,3,1
0284,pop_two,27,23,-4,25,26
0284,pop_white,565,341,-224,431,520
0284,vap,1231,1354,123,1305,1256
0284,vap_aian,11,6,-5,8,10
0284,vap_asian,18,78,60,54,30
0284,vap_black,117,148,31,136,123
0284,vap_hisp,557,800,243,703,606
0284,vap_nhpi,0,0,0,0,0
0284,vap_other,0,0,0,0,0
0284,vap_two,12,13,1,13,12
0284,vap_white,515,309,-206,391,474
0285,pop,612,613,1,613,612
0285,pop_aian,6,4,-2,5,6
0285,pop_asian,0,22,22,13,4
0285,pop_black,28,7,-21,15,24
0285,pop_hisp,423,453,30,441,429
0285,pop_nhpi,2,0,-2,1,2
0285,pop_other,0,3,3,2,1
0285,pop_two,6,13,7,10,7
0285,pop_white,147,111,-36,125,140
0285,vap,385,404,19,396,389
0285,vap_aian,3,4,1,4,3
0285,vap_asian,0,14,14,8,3
0285,vap_black,15,7,-8,10,13
0285,vap_hisp,243,272,29,260,249
0285,vap_nhpi,1,0,-1,0,1
0285,vap_other,0,3,3,2,1
0285,vap_two,2,4,2,3,2
0285,vap_white,121,100,-21,108,117
0286,pop,1341,1484,143,1427,1370
0286,pop_aian,2,0,-2,1,2
0286,pop_asian,14,99,85,65,31
0286,pop_black,50,41,-9,45,48
0286,pop_hisp,548,878,330,746,614
0286,pop_nhpi,1,0,-1,0,1
0286,pop_other,2,7,5,5,3
0286,pop_two,15,39,24,29,20
0286,pop_white,709,420,-289,536,651
0286,vap,1025,1082,57,1059,1036
0286,vap_aian,1,0,-1,0,1
0286,vap_asian,11,65,54,43,22
0286,vap_black,38,35,-3,36,37
0286,vap_hisp,331,560,229,468,377
0286,vap_nhpi,0,0,0,0,0
0286,vap_other,1,7,6,5,2
0286,vap_two,10,27,17,20,13
0286,vap_white,633,388,-245,486,584
0287,pop,1053,1061,8,1058,1055
0287,pop_aian,14,6,-8,9,12
0287,pop_asian,12,41,29,29,18
0287,pop_black,16,35,19,27,20
0287,pop_hisp,408,573,165,507,441
0287,pop_nhpi,0,0,0,0,0
0287,pop_other,4,7,3,6,5
0287,pop_two,15,28,13,23,18
0287,pop_white,584,371,-213,456,541
0287,vap,776,808,32,795,782
0287,vap_aian,13,5,-8,8,11
0287,vap_asian,9,19,10,15,11
0287,vap_black,8,28,20,20,12
0287,vap_hisp,252,400,148,341,282
0287,vap_nhpi,0,0,0,0,0
0287,vap_other,1,1,0,1,1
0287,vap_two,9,22,13,17,12
0287,vap_white,484,333,-151,393,454
0288,pop,2316,2583,267,2476,2369
0288,pop_aian,23,23,0,23,23
0288,pop_asian,20,189,169,121,54
0288,pop_black,51,58,7,55,52
0288,pop_hisp,808,1173,365,1027,881
0288,pop_nhpi,0,0,0,0,0
0288,pop_other,1,2,1,2,1
0288,pop_two,35,56,21,48,39
0288,pop_white,1378,1082,-296,1200,1319
0288,vap,1691,1896,205,1814,1732
0288,vap_aian,12,19,7,16,13
0288,vap_asian,15,111,96,73,34
0288,vap_black,33,43,10,39,35
0288,vap_hisp,496,795,299,675,556
0288,vap_nhpi,0,0,0,0,0
0288,vap_other,1,0,-1,0,1
0288,vap_two,16,31,15,25,19
0288,vap_white,1118,897,-221,985,1074
0289,pop,1867,2090,223,2001,1912
0289,pop_aian,8,10,2,9,8
0289,pop_asian,39,208,169,140,73
0289,pop_black,39,43,4,41,40
0289,pop_hisp,960,1284,324,1154,1025
0289,pop_nhpi,2,0,-2,1,2
0289,pop_other,0,3,3,2,1
0289,pop_two,25,35,10,31,27
0289,pop_white,794,507,-287,622,737
0289,vap,1300,1434,134,1380,1327
0289,vap_aian,8,10,2,9,8
0289,vap_asian,23,119,96,81,42
0289,vap_black,24,27,3,26,25
0289,vap_hisp,575,829,254,727,626
0289,vap_nhpi,2,0,-2,1,2
0289,vap_other,0,3,3,2,1
0289,vap_two,9,18,9,14,11
0289,vap_white,659,428,-231,520,613
0290,pop,2255,2242,-13,2247,2252
0290,pop_aian,25,17,-8,20,23
0290,pop_asian,38,103,65,77,51
0290,pop_black,60,95,35,81,67
0290,pop_hisp,1548,1581,33,1568,1555
0290,pop_nhpi,0,1,1,1,0
0290,pop_other,1,9,8,6,3
0290,pop_two,34,44,10,40,36
0290,pop_white,549,392,-157,455,518
0290,vap,1482,1556,74,1526,1497
0290,vap_aian,22,16,-6,18,21
0290,vap_asian,29,63,34,49,36
0290,vap_black,34,63,29,51,40
0290,vap_hisp,921,1050,129,998,947
0290,vap_nhpi,0,1,1,1,0
0290,vap_other,1,6,5,4,2
0290,vap_two,10,21,11,17,12
0290,vap_white,465,336,-129,388,439
0291,pop,1898,1977,79,1945,1914
0291,pop_aian,16,14,-2,15,16
0291,pop_asian,15,94,79,62,31
0291,pop_black,38,34,-4,36,37
0291,pop_hisp,1226,1412,186,1338,1263
0291,pop_nhpi,2,1,-1,1,2
0291,pop_other,3,4,1,4,3
0291,pop_two,14,26,12,21,16
0291,pop_white,584,392,-192,469,546
0291,vap,1284,1371,87,1336,1301
0291,vap_aian,11,13,2,12,11
0291,vap_asian,10,55,45,37,19
0291,vap_black,24,22,-2,23,24
0291,vap_hisp,726,916,190,840,764
0291,vap_nhpi,2,0,-2,1,2
0291,vap_other,1,4,3,3,2
0291,vap_two,8,11,3,10,9
0291,vap_white,502,350,-152,411,472
0292,pop,1485,1589,104,1547,1506
0292,pop_aian,13,14,1,14,13
0292,pop_asian,9,116,107,73,30
0292,pop_black,13,41,28,30,19
0292,pop_hisp,602,742,140,686,630
0292,pop_nhpi,0,0,0,0,0
0292,pop_other,2,10,8,7,4
0292,pop_two,21,44,23,35,26
0292,pop_white,825,622,-203,703,784
0292,vap,1087,1125,38,1110,1095
0292,vap_aian,11,9,-2,10,11
0292,vap_asian,6,58,52,37,16
0292,vap_black,10,21,11,17,12
0292,vap_hisp,353,477,124,427,378
0292,vap_nhpi,0,0,0,0,0
0292,vap_other,2,4,2,3,2
0292,vap_two,13,20,7,17,14
0292,vap_white,692,536,-156,598,661
0293,pop,1361,1344,-17,1351,1358
0293,pop_aian,14,5,-9,9,12
0293,pop_asian,14,19,5,17,15
0293,pop_black,16,25,9,21,18
0293,pop_hisp,200,289,89,253,218
0293,pop_nhpi,0,2,2,1,0
0293,pop_other,3,5,2,4,3
0293,pop_two,14,69,55,47,25
0293,pop_white,1100,930,-170,998,1066
0293,vap,1073,1058,-15,1064,1070
0293,vap_aian,10,5,-5,7,9
0293,vap_asian,9,15,6,13,10
0293,vap_black,9,23,14,17,12
0293,vap_hisp,128,169,41,153,136
0293,vap_nhpi,0,2,2,1,0
0293,vap_other,3,5,2,4,3
0293,vap_two,11,40,29,28,17
0293,vap_white,903,799,-104,841,882
0294,pop,1089,973,-116,1019,1066
0294,pop_aian,14,11,-3,12,13
0294,pop_asian,19,15,-4,17,18
0294,pop_black,13,8,-5,10,12
0294,pop_hisp,174,156,-18,163,170
0294,pop_nhpi,0,0,0,0,0
0294,pop_other,0,2,2,1,0
0294,pop_two,25,39,14,33,28
0294,pop_white,844,742,-102,783,824
0294,vap,840,796,-44,814,831
0294,vap_aian,10,10,0,10,10
0294,vap_asian,13,15,2,14,13
0294,vap_black,9,5,-4,7,8
0294,vap_hisp,100,105,5,103,101
0294,vap_nhpi,0,0,0,0,0
0294,vap_other,0,1,1,1,0
0294,vap_two,6,28,22,19,10
0294,vap_white,702,632,-70,660,688
0295,pop,1268,1240,-28,1251,1262
0295,pop_aian,32,5,-27,16,27
0295,pop_asian,13,16,3,15,14
0295,pop_black,17,33,16,27,20
0295,pop_hisp,188,267,79,235,204
0295,pop_nhpi,1,0,-1,0,1
0295,pop_other,1,3,2,2,1
0295,pop_two,30,80,50,60,40
0295,pop_white,986,836,-150,896,956
0295,vap,1029,1027,-2,1028,1029
0295,vap_aian,21,4,-17,11,18
0295,vap_asian,7,11,4,9,8
0295,vap_black,13,22,9,18,15
0295,vap_hisp,124,183,59,159,136
0295,vap_nhpi,1,0,-1,0,1
0295,vap_other,0,1,1,1,0
0295,vap_two,15,45,30,33,21
0295,vap_white,848,761,-87,796,831
0296,pop,1512,1481,-31,1493,1506
0296,pop_aian,11,10,-1,10,11
0296,pop_asian,24,16,-8,19,22
0296,pop_black,14,39,25,29,19
0296,pop_hisp,152,185,33,172,159
0296,pop_nhpi,2,0,-2,1,2
0296,pop_other,0,8,8,5,2
0296,pop_two,23,64,41,48,31
0296,pop_white,1286,1159,-127,1210,1261
0296,vap,1241,1221,-20,1229,1237
0296,vap_aian,9,10,1,10,9
0296,vap_asian,17,11,-6,13,16
0296,vap_black,9,30,21,22,13
0296,vap_hisp,93,110,17,103,96
0296,vap_nhpi,2,0,-2,1,2
0296,vap_other,0,8,8,5,2
0296,vap_two,13,42,29,30,19
0296,vap_white,1098,1010,-88,1045,1080
0297,pop,1283,1182,-101,1222,1263
0297,pop_aian,20,5,-15,11,17
0297,pop_asian,18,17,-1,17,18
0297,pop_black,38,29,-9,33,36
0297,pop_hisp,155,150,-5,152,154
0297,pop_nhpi,0,1,1,1,0
0297,pop_other,1,7,6,5,2
0297,pop_two,31,46,15,40,34
0297,pop_white,1020,927,-93,964,1001
0297,vap,1064,987,-77,1018,1049
0297,vap_aian,16,5,-11,9,14
0297,vap_asian,11,16,5,14,12
0297,vap_black,24,20,-4,22,23
0297,vap_hisp,102,110,8,107,104
0297,vap_nhpi,0,1,1,1,0
0297,vap_other,0,7,7,4,1
0297,vap_two,17,27,10,23,19
0297,vap_white,894,801,-93,838,875
0298,pop,1117,1135,18,1128,1121
0298,pop_aian,8,1,-7,4,7
0298,pop_asian,3,12,9,8,5
0298,pop_black,25,26,1,26,25
0298,pop_hisp,123,144,21,136,127
0298,pop_nhpi,0,0,0,0,0
0298,pop_other,1,10,9,6,3
0298,pop_two,13,29,16,23,16
0298,pop_white,944,913,-31,925,938
0298,vap,931,924,-7,927,930
0298,vap_aian,7,1,-6,3,6
0298,vap_asian,2,10,8,7,4
0298,vap_black,21,21,0,21,21
0298,vap_hisp,85,94,9,90,87
0298,vap_nhpi,0,0,0,0,0
0298,vap_other,0,6,6,4,1
0298,vap_two,9,21,12,16,11
0298,vap_white,807,771,-36,785,800
0299,pop,1384,1248,-136,1302,1357
0299,pop_aian,22,4,-18,11,18
0299,pop_asian,27,17,-10,21,25
0299,pop_black,10,18,8,15,12
0299,pop_hisp,109,111,2,110,109
0299,pop_nhpi,0,1,1,1,0
0299,pop_other,7,5,-2,6,7
0299,pop_two,39,76,37,61,46
0299,pop_white,1170,1016,-154,1078,1139
0299,vap,1155,1070,-85,1104,1138
0299,vap_aian,17,4,-13,9,14
0299,vap_asian,22,16,-6,18,21
0299,vap_black,6,15,9,11,8
0299,vap_hisp,69,72,3,71,70
0299,vap_nhpi,0,1,1,1,0
0299,vap_other,2,5,3,4,3
0299,vap_two,18,47,29,35,24
0299,vap_white,1021,910,-111,954,999
0300,pop,1619,1672,53,1651,1630
0300,pop_aian,7,8,1,8,7
0300,pop_asian,13,26,13,21,16
0300,pop_black,15,18,3,17,16
0300,pop_hisp,99,169,70,141,113
0300,pop_nhpi,0,0,0,0,0
0300,pop_other,1,10,9,6,3
0300,pop_two,11,65,54,43,22
0300,pop_white,1473,1376,-97,1415,1454
0300,vap,1382,1410,28,1399,1388
0300,vap_aian,7,7,0,7,7
0300,vap_asian,10,23,13,18,13
0300,vap_black,9,13,4,11,10
0300,vap_hisp,66,126,60,102,78
0300,vap_nhpi,0,0,0,0,0
0300,vap_other,0,10,10,6,2
0300,vap_two,6,38,32,25,12
0300,vap_white,1284,1193,-91,1229,1266
0301,pop,1900,1827,-73,1856,1885
0301,pop_aian,12,5,-7,8,11
0301,pop_asian,17,15,-2,16,17
0301,pop_black,42,66,24,56,47
0301,pop_hisp,211,261,50,241,221
0301,pop_nhpi,0,0,0,0,0
0301,pop_other,0,6,6,4,1
0301,pop_two,32,104,72,75,46
0301,pop_white,1586,1370,-216,1456,1543
0301,vap,1510,1492,-18,1499,1506
0301,vap_aian,8,5,-3,6,7
0301,vap_asian,7,12,5,10,8
0301,vap_black,29,40,11,36,31
0301,vap_hisp,121,169,48,150,131
0301,vap_nhpi,0,0,0,0,0
0301,vap_other,0,6,6,4,1
0301,vap_two,17,70,53,49,28
0301,vap_white,1328,1190,-138,1245,1300
0302,pop,1358,1369,11,1365,1360
0302,pop_aian,8,8,0,8,8
0302,pop_asian,19,21,2,20,19
0302,pop_black,37,59,22,50,41
0302,pop_hisp,188,261,73,232,203
0302,pop_nhpi,0,1,1,1,0
0302,pop_other,0,2,2,1,0
0302,pop_two,29,72,43,55,38
0302,pop_white,1077,945,-132,998,1051
0302,vap,1035,1087,52,1066,1045
0302,vap_aian,6,1,-5,3,5
0302,vap_asian,9,14,5,12,10
0302,vap_black,20,40,20,32,24
0302,vap_hisp,106,170,64,144,119
0302,vap_nhpi,0,1,1,1,0
0302,vap_other,0,1,1,1,0
0302,vap_two,12,56,44,38,21
0302,vap_white,882,804,-78,835,866
0303,pop,1836,1837,1,1837,1836
0303,pop_aian,6,15,9,11,8
0303,pop_asian,27,35,8,32,29
0303,pop_black,17,38,21,30,21
0303,pop_hisp,178,288,110,244,200
0303,pop_nhpi,0,0,0,0,0
0303,pop_other,1,1,0,1,1
0303,pop_two,23,71,48,52,33
0303,pop_white,1584,1389,-195,1467,1545
0303,vap,1454,1443,-11,1447,1452
0303,vap_aian,4,14,10,10,6
0303,vap_asian,21,21,0,21,21
0303,vap_black,8,22,14,16,11
0303,vap_hisp,111,185,74,155,126
0303,vap_nhpi,0,0,0,0,0
0303,vap_other,1,0,-1,0,1
0303,vap_two,10,42,32,29,16
0303,vap_white,1299,1159,-140,1215,1271
0304,pop,1818,1719,-99,1759,1798
0304,pop_aian,13,9,-4,11,12
0304,pop_asian,90,68,-22,77,86
0304,pop_black,34,96,62,71,46
0304,pop_hisp,335,332,-3,333,334
0304,pop_nhpi,0,1,1,1,0
0304,pop_other,5,1,-4,3,4
0304,pop_two,43,98,55,76,54
0304,pop_white,1298,1114,-184,1188,1261
0304,vap,1441,1381,-60,1405,1429
0304,vap_aian,12,9,-3,10,11
0304,vap_asian,70,53,-17,60,67
0304,vap_black,29,63,34,49,36
0304,vap_hisp,203,206,3,205,204
0304,vap_nhpi,0,0,0,0,0
0304,vap_other,4,0,-4,2,3
0304,vap_two,24,74,50,54,34
0304,vap_white,1099,976,-123,1025,1074
0305,pop,1621,1726,105,1684,1642
0305,pop_aian,13,8,-5,10,12
0305,pop_asian,9,19,10,15,11
0305,pop_black,12,39,27,28,17
0305,pop_hisp,170,393,223,304,215
0305,pop_nhpi,1,1,0,1,1
0305,pop_other,4,8,4,6,5
0305,pop_two,33,54,21,46,37
0305,pop_white,1379,1204,-175,1274,1344
0305,vap,1326,1390,64,1364,1339
0305,vap_aian,12,8,-4,10,11
0305,vap_asian,8,12,4,10,9
0305,vap_black,9,31,22,22,13
0305,vap_hisp,102,250,148,191,132
0305,vap_nhpi,1,0,-1,0,1
0305,vap_other,0,8,8,5,2
0305,vap_two,14,25,11,21,16
0305,vap_white,1180,1056,-124,1106,1155
0306,pop,1537,1759,222,1670,1581
0306,pop_aian,8,12,4,10,9
0306,pop_asian,26,161,135,107,53
0306,pop_black,108,97,-11,101,106
0306,pop_hisp,348,656,308,533,410
0306,pop_nhpi,0,0,0,0,0
0306,pop_other,3,3,0,3,3
0306,pop_two,34,54,20,46,38
0306,pop_white,1010,776,-234,870,963
0306,vap,1206,1267,61,1243,1218
0306,vap_aian,4,11,7,8,5
0306,vap_asian,20,88,68,61,34
0306,vap_black,64,64,0,64,64
0306,vap_hisp,210,377,167,310,243
0306,vap_nhpi,0,0,0,0,0
0306,vap_other,2,3,1,3,2
0306,vap_two,17,29,12,24,19
0306,vap_white,889,695,-194,773,850
0307,pop,1626,1823,197,1744,1665
0307,pop_aian,20,11,-9,15,18
0307,pop_asian,31,256,225,166,76
0307,pop_black,50,63,13,58,53
0307,pop_hisp,420,636,216,550,463
0307,pop_nhpi,0,2,2,1,0
0307,pop_other,1,10,9,6,3
0307,pop_two,31,55,24,45,36
0307,pop_white,1073,790,-283,903,1016
0307,vap,1254,1315,61,1291,1266
0307,vap_aian,12,9,-3,10,11
0307,vap_asian,21,150,129,98,47
0307,vap_black,30,38,8,35,32
0307,vap_hisp,265,398,133,345,292
0307,vap_nhpi,0,2,2,1,0
0307,vap_other,0,10,10,6,2
0307,vap_two,14,19,5,17,15
0307,vap_white,912,689,-223,778,867
0308,pop,2523,2474,-49,2494,2513
0308,pop_aian,23,14,-9,18,21
0308,pop_asian,229,389,160,325,261
0308,pop_black,149,540,391,384,227
0308,pop_hisp,756,667,-89,703,738
0308,pop_nhpi,2,2,0,2,2
0308,pop_other,9,11,2,10,9
0308,pop_two,72,85,13,80,75
0308,pop_white,1283,766,-517,973,1180
0308,vap,1868,1757,-111,1801,1846
0308,vap_aian,21,14,-7,17,20
0308,vap_asian,131,233,102,192,151
0308,vap_black,114,335,221,247,158
0308,vap_hisp,487,456,-31,468,481
0308,vap_nhpi,2,0,-2,1,2
0308,vap_other,8,11,3,10,9
0308,vap_two,43,50,7,47,44
0308,vap_white,1062,658,-404,820,981
0309,pop,2075,2195,120,2147,2099
0309,pop_aian,15,7,-8,10,13
0309,pop_asian,120,303,183,230,157
0309,pop_black,20,33,13,28,23
0309,pop_hisp,356,477,121,429,380
0309,pop_nhpi,6,1,-5,3,5
0309,pop_other,5,9,4,7,6
0309,pop_two,55,109,54,87,66
0309,pop_white,1498,1256,-242,1353,1450
0309,vap,1580,1633,53,1612,1591
0309,vap_aian,12,7,-5,9,11
0309,vap_asian,84,196,112,151,106
0309,vap_black,14,18,4,16,15
0309,vap_hisp,227,315,88,280,245
0309,vap_nhpi,2,0,-2,1,2
0309,vap_other,3,3,0,3,3
0309,vap_two,30,52,22,43,34
0309,vap_white,1208,1042,-166,1108,1175
0310,pop,1432,1532,100,1492,1452
0310,pop_aian,5,2,-3,3,4
0310,pop_asian,188,546,358,403,260
0310,pop_black,81,200,119,152,105
0310,pop_hisp,302,310,8,307,304
0310,pop_nhpi,0,0,0,0,0
0310,pop_other,0,7,7,4,1
0310,pop_two,88,38,-50,58,78
0310,pop_white,768,429,-339,565,700
0310,vap,933,940,7,937,934
0310,vap_aian,3,2,-1,2,3
0310,vap_asian,104,300,196,222,143
0310,vap_black,44,101,57,78,55
0310,vap_hisp,168,185,17,178,171
0310,vap_nhpi,0,0,0,0,0
0310,vap_other,0,3,3,2,1
0310,vap_two,41,22,-19,30,37
0310,vap_white,573,327,-246,425,524
0311,pop,1361,1504,143,1447,1390
0311,pop_aian,13,1,-12,6,11
0311,pop_asian,122,120,-2,121,122
0311,pop_black,37,61,24,51,42
0311,pop_hisp,188,270,82,237,204
0311,pop_nhpi,3,0,-3,1,2
0311,pop_other,3,6,3,5,4
0311,pop_two,46,88,42,71,54
0311,pop_white,949,958,9,954,951
0311,vap,997,1091,94,1053,1016
0311,vap_aian,9,1,-8,4,7
0311,vap_asian,78,77,-1,77,78
0311,vap_black,21,31,10,27,23
0311,vap_hisp,118,192,74,162,133
0311,vap_nhpi,3,0,-3,1,2
0311,vap_other,1,2,1,2,1
0311,vap_two,19,45,26,35,24
0311,vap_white,748,743,-5,745,747
0312,pop,1576,1633,57,1610,1587
0312,pop_aian,7,6,-1,6,7
0312,pop_asian,51,155,104,113,72
0312,pop_black,13,40,27,29,18
0312,pop_hisp,200,391,191,315,238
0312,pop_nhpi,0,0,0,0,0
0312,pop_other,0,2,2,1,0
0312,pop_two,29,49,20,41,33
0312,pop_white,1276,990,-286,1104,1219
0312,vap,1167,1253,86,1219,1184
0312,vap_aian,4,6,2,5,4
0312,vap_asian,35,100,65,74,48
0312,vap_black,10,37,27,26,15
0312,vap_hisp,124,262,138,207,152
0312,vap_nhpi,0,0,0,0,0
0312,vap_other,0,1,1,1,0
0312,vap_two,9,24,15,18,12
0312,vap_white,985,823,-162,888,953
0313,pop,3717,3783,66,3757,3730
0313,pop_aian,20,25,5,23,21
0313,pop_asian,118,355,237,260,165
0313,pop_black,100,194,94,156,119
0313,pop_hisp,533,747,214,661,576
0313,pop_nhpi,1,0,-1,0,1
0313,pop_other,8,11,3,10,9
0313,pop_two,76,129,53,108,87
0313,pop_white,2861,2322,-539,2538,2753
0313,vap,2871,2914,43,2897,2880
0313,vap_aian,14,23,9,19,16
0313,vap_asian,78,234,156,172,109
0313,vap_black,77,145,68,118,91
0313,vap_hisp,303,468,165,402,336
0313,vap_nhpi,1,0,-1,0,1
0313,vap_other,3,11,8,8,5
0313,vap_two,35,71,36,57,42
0313,vap_white,2360,1962,-398,2121,2280
0314,pop,1237,1162,-75,1192,1222
0314,pop_aian,12,8,-4,10,11
0314,pop_asian,20,64,44,46,29
0314,pop_black,11,43,32,30,17
0314,pop_hisp,198,248,50,228,208
0314,pop_nhpi,0,0,0,0,0
0314,pop_other,0,0,0,0,0
0314,pop_two,25,54,29,42,31
0314,pop_white,971,745,-226,835,926
0314,vap,941,916,-25,926,936
0314,vap_aian,7,6,-1,6,7
0314,vap_asian,12,45,33,32,19
0314,vap_black,8,22,14,16,11
0314,vap_hisp,131,175,44,157,140
0314,vap_nhpi,0,0,0,0,0
0314,vap_other,0,0,0,0,0
0314,vap_two,13,43,30,31,19
0314,vap_white,770,625,-145,683,741
0315,pop,2463,2542,79,2510,2479
0315,pop_aian,27,14,-13,19,24
0315,pop_asian,106,133,27,122,111
0315,pop_black,51,61,10,57,53
0315,pop_hisp,348,544,196,466,387
0315,pop_nhpi,1,0,-1,0,1
0315,pop_other,2,17,15,11,5
0315,pop_two,53,89,36,75,60
0315,pop_white,1875,1684,-191,1760,1837
0315,vap,1909,1974,65,1948,1922
0315,vap_aian,18,8,-10,12,16
0315,vap_asian,70,92,22,83,74
0315,vap_black,36,42,6,40,37
0315,vap_hisp,203,379,176,309,238
0315,vap_nhpi,1,0,-1,0,1
0315,vap_other,1,14,13,9,4
0315,vap_two,29,62,33,49,36
0315,vap_white,1551,1377,-174,1447,1516
0316,pop,1635,1679,44,1661,1644
0316,pop_aian,14,20,6,18,15
0316,pop_asian,79,102,23,93,84
0316,pop_black,23,55,32,42,29
0316,pop_hisp,232,515,283,402,289
0316,pop_nhpi,2,0,-2,1,2
0316,pop_other,0,15,15,9,3
0316,pop_two,15,57,42,40,23
0316,pop_white,1270,915,-355,1057,1199
0316,vap,1242,1243,1,1243,1242
0316,vap_aian,11,13,2,12,11
0316,vap_asian,49,68,19,60,53
0316,vap_black,17,34,17,27,20
0316,vap_hisp,151,321,170,253,185
0316,vap_nhpi,2,0,-2,1,2
0316,vap_other,0,11,11,7,2
0316,vap_two,9,37,28,26,15
0316,vap_white,1003,759,-244,857,954
0317,pop,1578,1528,-50,1548,1568
0317,pop_aian,9,11,2,10,9
0317,pop_asian,22,49,27,38,27
0317,pop_black,25,41,16,35,28
0317,pop_hisp,305,349,44,331,314
0317,pop_nhpi,0,3,3,2,1
0317,pop_other,2,1,-1,1,2
0317,pop_two,38,68,30,56,44
0317,pop_white,1177,1006,-171,1074,1143
0317,vap,1191,1186,-5,1188,1190
0317,vap_aian,8,7,-1,7,8
0317,vap_asian,15,31,16,25,18
0317,vap_black,16,31,15,25,19
0317,vap_hisp,189,224,35,210,196
0317,vap_nhpi,0,3,3,2,1
0317,vap_other,1,0,-1,0,1
0317,vap_two,22,36,14,30,25
0317,vap_white,940,854,-86,888,923
0319,pop,0,0,0,0,0
0319,pop_aian,0,0,0,0,0
0319,pop_asian,0,0,0,0,0
0319,pop_black,0,0,0,0,0
0319,pop_hisp,0,0,0,0,0
0319,pop_nhpi,0,0,0,0,0
0319,pop_other,0,0,0,0,0
0319,pop_two,0,0,0,0,0
0319,pop_white,0,0,0,0,0
0319,vap,0,0,0,0,0
0319,vap_aian,0,0,0,0,0
0319,vap_asian,0,0,0,0,0
0319,vap_black,0,0,0,0,0
0319,vap_hisp,0,0,0,0,0
0319,vap_nhpi,0,0,0,0,0
0319,vap_other,0,0,0,0,0
0319,vap_two,0,0,0,0,0
0319,vap_white,0,0,0,0,0
0320,pop,96,116,20,108,100
0320,pop_aian,2,0,-2,1,2
0320,pop_asian,0,1,1,1,0
0320,pop_black,29,65,36,51,36
0320,pop_hisp,15,25,10,21,17
0320,pop_nhpi,0,0,0,0,0
0320,pop_other,0,2,2,1,0
0320,pop_two,5,0,-5,2,4
0320,pop_white,45,23,-22,32,41
0320,vap,84,93,9,89,86
0320,vap_aian,2,0,-2,1,2
0320,vap_asian,0,1,1,1,0
0320,vap_black,26,48,22,39,30
0320,vap_hisp,14,19,5,17,15
0320,vap_nhpi,0,0,0,0,0
0320,vap_other,0,2,2,1,0
0320,vap_two,2,0,-2,1,2
0320,vap_white,40,23,-17,30,37
0321,pop,1327,1074,-253,1175,1276
0321,pop_aian,8,4,-4,6,7
0321,pop_asian,49,19,-30,31,43
0321,pop_black,147,169,22,160,151
0321,pop_hisp,983,807,-176,877,948
0321,pop_nhpi,1,1,0,1,1
0321,pop_other,0,2,2,1,0
0321,pop_two,14,23,9,19,16
0321,pop_white,125,49,-76,79,110
0321,vap,813,718,-95,756,794
0321,vap_aian,6,1,-5,3,5
0321,vap_asian,34,12,-22,21,30
0321,vap_black,73,111,38,96,81
0321,vap_hisp,589,542,-47,561,580
0321,vap_nhpi,1,0,-1,0,1
0321,vap_other,0,1,1,1,0
0321,vap_two,6,8,2,7,6
0321,vap_white,104,43,-61,67,92
0322,pop,522,551,29,539,528
0322,pop_aian,4,0,-4,2,3
0322,pop_asian,7,5,-2,6,7
0322,pop_black,29,47,18,40,33
0322,pop_hisp,362,422,60,398,374
0322,pop_nhpi,2,0,-2,1,2
0322,pop_other,2,4,2,3,2
0322,pop_two,5,13,8,10,7
0322,pop_white,111,60,-51,80,101
0322,vap,338,337,-1,337,338
0322,vap_aian,3,0,-3,1,2
0322,vap_asian,5,4,-1,4,5
0322,vap_black,16,16,0,16,16
0322,vap_hisp,211,255,44,237,220
0322,vap_nhpi,0,0,0,0,0
0322,vap_other,0,4,4,2,1
0322,vap_two,1,3,2,2,1
0322,vap_white,102,55,-47,74,93
0323,pop,1239,1179,-60,1203,1227
0323,pop_aian,21,12,-9,16,19
0323,pop_asian,17,99,82,66,33
0323,pop_black,75,61,-14,67,72
0323,pop_hisp,911,870,-41,886,903
0323,pop_nhpi,0,0,0,0,0
0323,pop_other,0,2,2,1,0
0323,pop_two,9,22,13,17,12
0323,pop_white,206,113,-93,150,187
0323,vap,784,817,33,804,791
0323,vap_aian,14,11,-3,12,13
0323,vap_asian,6,52,46,34,15
0323,vap_black,49,43,-6,45,48
0323,vap_hisp,540,597,57,574,551
0323,vap_nhpi,0,0,0,0,0
0323,vap_other,0,2,2,1,0
0323,vap_two,4,10,6,8,5
0323,vap_white,171,102,-69,130,157
0324,pop,727,741,14,735,730
0324,pop_aian,1,3,2,2,1
0324,pop_asian,11,29,18,22,15
0324,pop_black,64,67,3,66,65
0324,pop_hisp,527,526,-1,526,527
0324,pop_nhpi,0,2,2,1,0
0324,pop_other,0,7,7,4,1
0324,pop_two,18,13,-5,15,17
0324,pop_white,106,94,-12,99,104
0324,vap,455,454,-1,454,455
0324,vap_aian,1,3,2,2,1
0324,vap_asian,4,13,9,9,6
0324,vap_black,30,31,1,31,30
0324,vap_hisp,323,315,-8,318,321
0324,vap_nhpi,0,2,2,1,0
0324,vap_other,0,4,4,2,1
0324,vap_two,5,9,4,7,6
0324,vap_white,92,77,-15,83,89
0325,pop,666,752,86,718,683
0325,pop_aian,9,8,-1,8,9
0325,pop_asian,21,23,2,22,21
0325,pop_black,19,42,23,33,24
0325,pop_hisp,167,179,12,174,169
0325,pop_nhpi,0,0,0,0,0
0325,pop_other,1,0,-1,0,1
0325,pop_two,18,40,22,31,22
0325,pop_white,431,460,29,448,437
0325,vap,508,582,74,552,523
0325,vap_aian,6,7,1,7,6
0325,vap_asian,9,12,3,11,10
0325,vap_black,14,36,22,27,18
0325,vap_hisp,105,110,5,108,106
0325,vap_nhpi,0,0,0,0,0
0325,vap_other,1,0,-1,0,1
0325,vap_two,7,33,26,23,12
0325,vap_white,366,384,18,377,370
0326,pop,4,27,23,18,9
0326,pop_aian,0,0,0,0,0
0326,pop_asian,0,0,0,0,0
0326,pop_black,0,0,0,0,0
0326,pop_hisp,3,23,20,15,7
0326,pop_nhpi,0,0,0,0,0
0326,pop_other,0,0,0,0,0
0326,pop_two,0,3,3,2,1
0326,pop_white,1,1,0,1,1
0326,vap,2,14,12,9,4
0326,vap_aian,0,0,0,0,0
0326,vap_asian,0,0,0,0,0
0326,vap_black,0,0,0,0,0
0326,vap_hisp,2,11,9,7,4
0326,vap_nhpi,0,0,0,0,0
0326,vap_other,0,0,0,0,0
0326,vap_two,0,2,2,1,0
0326,vap_white,1,1,0,1,1
0327,pop,1,0,-1,0,1
0327,pop_aian,0,0,0,0,0
0327,pop_asian,0,0,0,0,0
0327,pop_black,0,0,0,0,0
0327,pop_hisp,1,0,-1,0,1
0327,pop_nhpi,0,0,0,0,0
0327,pop_other,0,0,0,0,0
0327,pop_two,0,0,0,0,0
0327,pop_white,0,0,0,0,0
0327,vap,1,0,-1,0,1
0327,vap_aian,0,0,0,0,0
0327,vap_asian,0,0,0,0,0
0327,vap_black,0,0,0,0,0
0327,vap_hisp,1,0,-1,0,1
0327,vap_nhpi,0,0,0,0,0
0327,vap_other,0,0,0,0,0
0327,vap_two,0,0,0,0,0
0327,vap_white,0,0,0,0,0
